аба-в€залас€	абав€залас€
вбвв€эвны	абав€заны
абав€-зацельстваҐ	абав€зацельстваҐ
абав€за-цельствы	абав€зацельствы
абав€эацельствы	абав€зацельствы
абав€з-кам	абав€зкам
абав€з-кова	абав€зкова
аба€€зкова	абав€зкова
абап≥раючы-с€	абап≥раючыс€
аба-ран≥ць	абаран≥ць
абаро-ну	абарону
аба-ронцаҐ	абаронцаҐ
абедэен-ны	абедзенны
аб'-Єм	аб'Єм
абко-ма	абкома
аб-ласнога	абласнога
абласно-га	абласнога
аб-ласной	абласной
абла-сны	абласны
аб-лЄту	аблЄту
аб-л≥чча	абл≥чча
абл€-цеҐ	абл€цеҐ
аб-меркаваннем	абмеркаваннем
абмеркавань	абмеркаваць
вбо	або
лбо	або
абслугоҐ-ванн€	абслугоҐванн€
абста-в≥нах	абстав≥нах
абстал€ван-не	абстал€ванне
абстал€ван-н€	абстал€ванн€
абстаноҐны	абстаноҐцы
абста-ноҐцы	абстаноҐцы
абстаноҐ-цы	абстаноҐцы
абурал≥-с€	абурал≥с€
аб'€д-нанай	аб'€днанай
аб'-€днанне	аб'€днанне
аб'-€днанн€	аб'€днанн€
аб€-цал≥	аб€цал≥
авало-данн€	авалоданн€
авалодан-н€	авалоданн€
авангар-дзе	авангардзе
аван-тур	авантур
ав≥€-цы≥	ав≥€цы≥
ав≥€цый-ным	ав≥€цыйным
ага-пк≥	агапк≥
агенц-тва	агенцтва
аг≥таны≥	аг≥тацы≥
вг≥тбрыгвдв	аг≥тбрыгада
агл€л	агл€д
вг-л€ду	агл€ду
аг-н≥	агн≥
агра-ном	аграном
аг-ранома	агранома
агуль-ных	агульных
агур-к≥	агурк≥
адб≥-л≥с€	адб≥л≥с€
ад-будзецца	адбудзецца
адбу-дзецца	адбудзецца
ад-бываецца	адбываецца
адбывасцца	адбываецца
албываецца	адбываецца
адбы-ваюцца	адбываюцца
ад-былас€	адбылас€
€дбылас€	адбылас€
ад-был≥с€	адбыл≥с€
адбы-л≥с€	адбыл≥с€
адбыл≥-с€	адбыл≥с€
албыл≥с€	адбыл≥с€
адбы-лос€	адбылос€
адбыло-с€	адбылос€
ад-быҐс€	адбыҐс€
адбыҐ-с€	адбыҐс€
вдбыҐс€	адбыҐс€
вд-быҐс€	адбыҐс€
ад-быцца	адбыцца
адда-ваць	аддаваць
алдаецца	аддаецца
адлаҐ	аддаҐ
ал-даць	аддаць
аддзе-ла	аддзела
аддзелв	аддзела
аддзсла	аддзела
аддэела	аддзела
аддз€-ленне	аддз€ленне
аддз€лен-не	аддз€ленне
алдз€ленн≥	аддз€ленн≥
адл≥н	адз≥н
адэ≥н	адз≥н
алз≥н	адз≥н
вдз≥н	адз≥н
адз≥мы	адз≥ны
адэ≥ным	адз≥ным
адэначае	адзначае
ад-значаюць	адзначаюць
адзна-чаюць	адзначаюць
адзначынь	адзначыць
ад-значыць	адзначыць
адзна-чыць	адзначыць
адкаэ	адказ
алказ	адказ
ад-казаҐ	адказаҐ
алказаҐ	адказаҐ
ад-казвае	адказвае
ад-казваюць	адказваюць
ад-казнаснь	адказнасць
адказ-наснь	адказнасць
адкаэны	адказны
ад-каэны	адказны
адкаэу	адказу
алказу	адказу
адкры-вае	адкрывае
адкры-ваецца	адкрываецца
алкрылас€	адкрылас€
ад-крыта	адкрыта
алкрыта	адкрыта
ал-крыта	адкрыта
ад-крыты	адкрыты
адкры-ты	адкрыты
алкрыты	адкрыты
ад-крытым	адкрытым
алкрытым	адкрытым
ад-крыты€	адкрыты€
ад-крыҐ	адкрыҐ
алкрыҐ	адкрыҐ
ад-крыцц€Ґ	адкрыцц€Ґ
алкуль	адкуль
адлюстра-ванне	адлюстраванне
адлю-страванн€	адлюстраванн€
аллюстраваны	адлюстраваны
ад-люстроҐвае	адлюстроҐвае
адлюстроҐ-вае	адлюстроҐвае
адлю-строҐвайце	адлюстроҐвайце
адлюстроҐваюнь	адлюстроҐваюць
адлю-строҐваюць	адлюстроҐваюць
ад-моҐна	адмоҐна
адмоҐ-нага	адмоҐнага
адмоҐна-га	адмоҐнага
ад-на	адна
аднв	адна
адн€	адна
ална	адна
вдна	адна
здна	адна
лдна	адна
ад-наго	аднаго
адна-го	аднаго
адпаго	аднаго
алнаго	аднаго
лднаго	аднаго
ад-нак	аднак
јднвк	јднак
јднзк	аднак
јлнак	јднак
алнак	аднак
ад-наму	аднаму
алнаму	аднаму
алначасова	адначасова
ад-несц≥	аднесц≥
ад-но	адно
ално	адно
€дно	адно
ад-ной	адной
јлной	јдной
алной	адной
адной-чы	аднойчы
јлнойчы	јднойчы
аднос≥-нах	аднос≥нах
ад-нос≥ны	аднос≥ны
алнос≥ны	аднос≥ны
алну	адну
ал-ну	адну
ад-ны	адны
јлны	јдны
адмым	адным
аднмм	адным
ад-ным	адным
алным	адным
лдным	адным
адпав€-дае	адпав€дае
адпав€дас	адпав€дае
адпа-чываҐ	адпачываҐ
ад-пачынак	адпачынак
адначынку	адпачынку
адна-чынку	адпачынку
ад-пачынку	адпачынку
адпачын-ку	адпачынку
адпра-в≥ць	адправ≥ць
адпраҐле-ны	адпраҐлены
ад-разу	адразу
адраэу	адразу
алразу	адразу
вдразу	адразу
адрас-нае	адраснае
ад-стайвае	адстайвае
адста-ласц≥	адсталасц≥
адста-лую	адсталую
адста-€л≥	адста€л≥
адсутнаснь	адсутнасць
адсутн≥-чае	адсутн≥чае
јлсюль	јдсюль
аду-кацыю	адукацыю
адука-цыю	адукацыю
адукацы-€й	адукацы€й
ад-чуваецца	адчуваецца
адчува-ецца	адчуваецца
адчувасцца	адчуваецца
алчуваецца	адчуваецца
алчуваеш	адчуваеш
ад-чуваҐ	адчуваҐ
алчуваць	адчуваць
ад-чуваю	адчуваю
адчуваюнь	адчуваюць
вдчул≥	адчул≥
ад-чуць	адчуць
ады-шл≥	адышл≥
ажыцц€в≥-л≥	ажыцц€в≥л≥
ажыцц€Ґ-ленне	ажыцц€Ґленне
ажыцц€Ґленнс	ажыцц€Ґленне
ажыцц€Ґ-ленн≥	ажыцц€Ґленн≥
ажыц-ц€Ґленн€	ажыцц€Ґленн€
јз≤≤	јз≥≥
аэначае	азначае
айчын-най	айчыннай
јйчыннвй	јйчыннай
јйчыннлй	јйчыннай
акадэ-м≥≥	акадэм≥≥
јкалэм≥≥	јкадэм≥≥
акалэм≥ка	акадэм≥ка
аказань	аказаць
ак-варэл≥	акварэл≥
ак≥-€нам	ак≥€нам
акты-в≥стаҐ	актыв≥стаҐ
ак-тыҐнага	актыҐнага
актыҐна-га	актыҐнага
актыҐ-ны	актыҐны
вктыҐны	актыҐны
ак-тыҐным≥	актыҐным≥
актыҐны-м≥	актыҐным≥
акцср	акцЄр
акнЄра	акцЄра
акнЄрам	акцЄрам
акнЄры	акцЄры
алс	але
вле	але
Ћле	але
Ћлс	але
але-с€	алес€
ал≥м-п≥€да	ал≥мп≥€да
алоҐн≥-каҐ	алоҐн≥каҐ
ал€ксанлр	ал€ксандр
јп€ксандр	јл€ксандр
ал€к-сандра	ал€ксандра
јл€ксанлра	јл€ксандра
ал€к-свндрв	ал€ксандра
лл€к-сандра	ал€ксандра
ал€к-сеев≥ч	ал€ксеев≥ч
ал€ксее-в≥ч	ал€ксеев≥ч
ал€ксесв≥ч	ал€ксеев≥ч
ал€к-сеев≥чу	ал€ксеев≥чу
ал€ксеев≥-чу	ал€ксеев≥чу
ал€-ксей	ал€ксей
јл€ксс€	јл€ксе€
амзль	амаль
амлль	амаль
ам€ль	амаль
лмаль	амаль
€маль	амаль
амерыкан-скага	амерыканскага
аме-рыканскай	амерыканскай
амерыкан-ск≥м≥	амерыканск≥м≥
амерыкан-ск≥х	амерыканск≥х
амерыкан-ск≥€	амерыканск≥€
аме-рык≥	амерык≥
амеры-к≥	амерык≥
амс-рык≥	амерык≥
јмерыны	јмерыцы
ана-толь	анатоль
анл-тол€	анатол€
јнгл≤≤	јнгл≥≥
англ≥й-скай	англ≥йскай
јнлрэй	јндрэй
ан-тон	антон
ан-тонаҐ	антонаҐ
ан-тыкамун≥зма	антыкамун≥зма
апав€-дае	апав€дае
апав€дан-не	апав€данне
апав€даннс	апав€данне
апав€-ланне	апав€данне
апав€-данн≥	апав€данн≥
апав€дзнн≥	апав€данн≥
апав€ланн≥	апав€данн≥
апа-в€данн€	апав€данн€
апав€ланн€	апав€данн€
апав€-данн€Ґ	апав€данн€Ґ
апав€ланн€Ґ	апав€данн€Ґ
апав€лан-н€Ґ	апав€данн€Ґ
апав€ланн€х	апав€данн€х
апа-раты	апараты
апладысмен-таҐ	апладысментаҐ
анладысменты	апладысменты
апла-дысменты	апладысменты
апладыс-менты	апладысменты
апладысмен-ты	апладысменты
апла-дысмснты	апладысменты
апладысмсн-ты	апладысменты
аплалысменты	апладысменты
јплалысменты	јпладысменты
ап-лата	аплата
апоаесц≥	аповесц≥
аповесн≥	аповесц≥
аповесп≥	аповесц≥
апо-весц≥	аповесц≥
аповссц≥	аповесц≥
апо€есц≥	аповесц≥
лповесц≥	аповесц≥
јповеснь	јповесць
апо-весць	аповесць
аповссць	аповесць
јповссць	јповесць
апо€есць	аповесць
€повесць	аповесць
апош-н≥	апошн≥
лпошн≥	апошн≥
апош-н≥х	апошн≥х
апош-н≥€	апошн≥€
впошн≥€	апошн≥€
€пошн≥€	апошн≥€
апош-н€га	апошн€га
апош-н€й	апошн€й
апра-цоҐку	апрацоҐку
ап€рэджва-юць	ап€рэджваюць
аран-бургу	аранбургу
арб≥-ту	арб≥ту
арб≥цс	арб≥це
ар-ган≥завал≥	арган≥завал≥
арган≥-заваны	арган≥заваны
арган≥за-ваҐ	арган≥заваҐ
арган≥за-ваць	арган≥заваць
ар-ган≥затар	арган≥затар
арган≥за-тары	арган≥затары
арган≥заны≥	арган≥зацы≥
арга-н≥зацы≥	арган≥зацы≥
арган≥-зацы≥	арган≥зацы≥
ар-ган≥эацы≥	арган≥зацы≥
арга-н≥эацы≥	арган≥зацы≥
арган≥заный	арган≥зацый
арга-н≥зацый	арган≥зацый
арган≥зацын	арган≥зацый
арган≥заны€	арган≥зацы€
арган≥эа-цы€	арган≥зацы€
ар-ган≥зацы€й	арган≥зацы€й
арган≥заны€х	арган≥зацы€х
арган≥эм	арган≥зм
арга-н≥чна	арган≥чна
ар-генц≥не	аргенц≥не
арген-ц≥не	аргенц≥не
аргенц≥-ны	аргенц≥ны
аркадэь	аркадзь
арксстр	аркестр
ар-кестра	аркестра
аркестрв	аркестра
арке-страм	аркестрам
арксстрам	аркестрам
€ркестрам	аркестрам
аркестрау	аркестраҐ
ар-кестраҐ	аркестраҐ
ар-м≥ю	арм≥ю
ар-м€нскай	арм€нскай
арм€н-скай	арм€нскай
вртыкул	артыкул
врты-кул	артыкул
арты-куле	артыкуле
артыкулс	артыкуле
вртыкулы	артыкулы
ар-тыст	артыст
нртыст	артыст
ар-тыста	артыста
арты-ста	артыста
артыстл	артыста
артыста≥	артыстам
артыс-там	артыстам
артыста-м≥	артыстам≥
артысгаҐ	артыстаҐ
ар-тыстаҐ	артыстаҐ
арты-стаҐ	артыстаҐ
артыс-таҐ	артыстаҐ
вртыстаҐ	артыстаҐ
артыст-ка	артыстка
артыгты	артысты
ар-тыгты	артысты
ар-тысты	артысты
арты-сты	артысты
артыс-ты	артысты
лртысты	артысты
пртысты	артысты
ар-фаграф≥чны	арфаграф≥чны
арфа-граф≥чны	арфаграф≥чны
арфаграф≥ч-ны	арфаграф≥чны
арфагра-ф≥чным	арфаграф≥чным
архе-алаг≥чны€	археалаг≥чны€
арцсл≥	арцел≥
врце-л≥	арцел≥
ар-шанскага	аршанскага
а-ры≥	ары≥
аса-б≥ста	асаб≥ста
асаб≥с-тае	асаб≥стае
јсабл≥аа	јсабл≥ва
асабл≥аа	асабл≥ва
асаб-л≥ва	асабл≥ва
асабл≥-ва	асабл≥ва
асабл≥в€	асабл≥ва
јсабл≥на	јсабл≥ва
асабл≥на	асабл≥ва
асабл≥€а	асабл≥ва
€сабл≥ва	асабл≥ва
асабл≥ва-га	асабл≥вага
асаб-л≥вай	асабл≥вай
асабл≥-вай	асабл≥вай
асаб-л≥васц≥	асабл≥васц≥
асабл≥-васц≥	асабл≥васц≥
асабл≥вас-ц≥	асабл≥васц≥
асабл≥васн€м≥	асабл≥васц€м≥
асабл≥-вы€	асабл≥вы€
асва-енне	асваенне
асва-енн≥	асваенн≥
ас-ваенн€	асваенн€
ас-войвае	асвойвае
ас-в€тленне	асв€тленне
ас≥-пенк≥	ас≥пенк≥
ас-нова	аснова
асно-ву	аснову
асноҐ-нага	асноҐнага
асноҐ-най	асноҐнай
асноҐ-на€	асноҐна€
ас-ноҐных	асноҐных
асноҐ-ных	асноҐных
асоб-ны€	асобны€
јсошызйтэд	јсошыэйтэд
ас-татн€е	астатн€е
асу-анскай	асуанскай
асуджа-ны	асуджаны
асу-джаючы	асуджаючы
асц€-рожна	асц€рожна
'атмасфера	атмасфера
атрала	атрада
атрак-цыЄны	атракцыЄны
ат-рымала	атрымала
атры-мала	атрымала
атры-маных	атрыманых
атры-маҐ	атрымаҐ
атрым€Ґ	атрымаҐ
атрымань	атрымаць
ат-рымл≥вае	атрымл≥вае
атрым-л≥ваю	атрымл≥ваю
ау-тар	аутар
аҐро-ры	аҐроры
аҐта-завода	аҐтазавода
аҐтаза-вода	аҐтазавода
аҐталавода	аҐтазавода
аҐтамаб≥лебу-даҐн≥коҐ	аҐтамаб≥лебудаҐн≥коҐ
аҐта-маб≥л≥	аҐтамаб≥л≥
аҐ-тамаб≥льным	аҐтамаб≥льным
аҐта-матычных	аҐтаматычных
аҐта-машыны	аҐтамашыны
аҐтама-шыны	аҐтамашыны
вҐта-номных	аҐтаномных
аҐтвр	аҐтар
€Ґтара	аҐтара
аҐта-рам	аҐтарам
аҐта-раҐ	аҐтараҐ
аҐ-тарытэт	аҐтарытэт
аҐтары-тэт	аҐтарытэт
аҐтаса-мазвала	аҐтасамазвала
аҐта-самазвалы	аҐтасамазвалы
аҐтасама-звалы	аҐтасамазвалы
аҐто-бусы	аҐтобусы
афармлен-не	афармленне
афармленнс	афармленне
афар-мленн≥	афармленн≥
афарм-ленн≥	афармленн≥
афармле≥≥н€	афармленн€
афар-мленн€	афармленн€
аф≥цэ-ра	аф≥цэра
аф≥цэ-рам≥	аф≥цэрам≥
афор-м≥ць	аформ≥ць
афры-канск≥€	афрыканск≥€
аф-рык≥	афрык≥
ах-вотна	ахвотна
ахоны	аховы
ба-гаты	багаты
бага-ты	багаты
бага-тым	багатым
багаты-рова	багатырова
багац-це	багацце
ба-гацц≥	багацц≥
багац-ц€Ґ	багацц€Ґ
Ѕагланов≥ч	Ѕагданов≥ч
ба-зу	базу
баэу	базу
баэы	базы
бай-цоҐ	байцоҐ
ба-ку	баку
балга-ры€	балгары€
балстных	балетных
ба-лету	балету
бале-ту	балету
ба-лота	балота
ба-лоты	балоты
бало-ты	балоты
бало-це	балоце
баль-н≥ц	бальн≥ц
баль-н≥цы	бальн≥цы
бальн≥-цы	бальн≥цы
ба-рацьба	барацьба
бараць-ба	барацьба
бараньбе	барацьбе
барапьбе	барацьбе
ба-рацьбе	барацьбе
барацьбс	барацьбе
бараць-б≥тоҐ	барацьб≥тоҐ
бараньбу	барацьбу
барань-бу	барацьбу
барапьбу	барацьбу
барапь-бу	барацьбу
ба-рацьбу	барацьбу
бараньбы	барацьбы
бараць-бы	барацьбы
б€рацьбы	барацьбы
барта-шэв≥ч	барташэв≥ч
барташэ-в≥ч	барташэв≥ч
ба-рыс	барыс
баталь-Єн	батальЄн
батан≥чна-га	батан≥чнага
бахмай-ер	бахмайер
бацькз	бацька
баць-коҐ	бацькоҐ
бача-чы	бачачы
ба-чым	бачым
б€чым	бачым
б€-чым	бачым
ба-чыҐ	бачыҐ
б€чыҐ	бачыҐ
бачыне	бачыце
бачынь	бачыць
бачыпь	бачыць
ба-чыць	бачыць
ба€л≥-с€	ба€л≥с€
ба€-н≥ста	ба€н≥ста
ба€Ґ-с€	ба€Ґс€
ба€ш≥а	ба€цца
беэ	без
бсз	без
безу-моҐна	безумоҐна
беэумоҐна	безумоҐна
белару-са	беларуса
бела-русаҐ	беларусаҐ
бсларусаҐ	беларусаҐ
бе-ларус≥	беларус≥
бела-рус≥	беларус≥
белару-с≥	беларус≥
Ѕелврус≥	Ѕеларус≥
белвру-с≥	беларус≥
бел€рус≥	беларус≥
Ѕепарус≥	Ѕеларус≥
бо-ларус≥	беларус≥
бола-рус≥	беларус≥
бсларус≥	беларус≥
веларус≥	беларус≥
вела-рус≥	беларус≥
б^аруска≥а	беларускага
бе-ларускага	беларускага
бела-рускага	беларускага
беларуска-га	беларускага
белврускага	беларускага
бел€рускага	беларускага
бсларускага	беларускага
веларускага	беларускага
Ѕ≈Ћј–— ƒ…	беларускай
беларуска≥≥	беларускай
бе-ларускай	беларускай
бела-рускай	беларускай
белару-скай	беларускай
беларус-кай	беларускай
беларускан	беларускай
беларуск€й	беларускай
белврускай	беларускай
беллрускай	беларускай
Ѕеллрускай	Ѕеларускай
бел€рускай	беларускай
бсларускай	беларускай
бс-ларускай	беларускай
бсларус-кай	беларускай
беларус-каму	беларускаму
бе-ларуска€	беларуска€
бела-руска€	беларуска€
беларус-ка€	беларуска€
белв-руска€	беларуска€
бсларуска€	беларуска€
беллруск≥	беларуск≥
Ѕсларуск≥	Ѕеларуск≥
веларуск≥	беларуск≥
вела-руск≥	беларуск≥
бела-руск≥м	беларуск≥м
беларус-к≥м	беларуск≥м
бсларуск≥м	беларуск≥м
бе-ларуск≥м≥	беларуск≥м≥
белвруск≥м≥	беларуск≥м≥
бсла-руск≥м≥	беларуск≥м≥
бсларуск≥-м≥	беларуск≥м≥
бе-ларуск≥х	беларуск≥х
бела-руск≥х	беларуск≥х
белару-ск≥х	беларуск≥х
беларус-к≥х	беларуск≥х
белвруск≥х	беларуск≥х
белв-руск≥х	беларуск≥х
бсларуск≥х	беларуск≥х
бслару-ск≥х	беларуск≥х
бела-руск≥€	беларуск≥€
бел€руск≥€	беларуск≥€
бсларуск≥€	беларуск≥€
бслару-ск≥€	беларуск≥€
беларус-кую	беларускую
бел€рускую	беларускую
бсларускую	беларускую
бсларусы	беларусы
бела-русь	беларусь
Ѕелврусь	Ѕеларусь
¬еларусь	Ѕеларусь
веларусь-	беларусь
Ѕеларусь2	Ѕеларусь 2
беларусь-ф≥льм	беларусьф≥льм
Ѕелгародека€	Ѕелгародска€
велы	белы
бен-гальск≥м	бенгальск≥м
беражл≥-ва	беражл≥ва
бсс	бес
бес-працоҐе	беспрацоҐе
беэ-умоҐна	беэумоҐна
б≥бл≥€тзк	б≥бл≥€тэк
б≥б-л≥€тэк	б≥бл≥€тэк
б≥бл≥нтэ-ка	б≥бл≥€тэка
б≥бл≥€гэка	б≥бл≥€тэка
б≥бл≥€тзка	б≥бл≥€тэка
б≥б-л≥€тэка	б≥бл≥€тэка
б≥бл≥€-тэка	б≥бл≥€тэка
б≥бл≥€тэ-ка	б≥бл≥€тэка
б≥бл≥€-тэкв	б≥бл≥€тэка
б≥б-л≥€тэкл	б≥бл≥€тэка
б≥бл≥€-тэк€	б≥бл≥€тэка
б≥бл≥€гэк≥	б≥бл≥€тэк≥
б≥б-л≥€тэк≥	б≥бл≥€тэк≥
б≥бл≥€-тэк≥	б≥бл≥€тэк≥
б≥бл≥€тэ-к≥	б≥бл≥€тэк≥
б≥-бл≥€тэку	б≥бл≥€тэку
б≥б-л≥€тэку	б≥бл≥€тэку
б≥бл≥-€тэку	б≥бл≥€тэку
б≥бл≥€тзцы	б≥бл≥€тэцы
б≥бл≥€тчцы	б≥бл≥€тэцы
б≥бл≥€тэны	б≥бл≥€тэцы
бл≥-жэйшы	бл≥жэйшы
бл≥жэй-шы€	бл≥жэйшы€
бл≥эка	бл≥зка
бл≥эк≥х	бл≥зк≥х
бл≥эк≥€	бл≥зк≥€
бло-каҐ	блокаҐ
блуд-н≥цы	блудн≥цы
болын	больш
болып	больш
больн≥	больш
бопьш	больш
боль-шасць	большасць
большменш	больш-менш
боль-шы	большы
большы-м≥	большым≥
бпм-бы	бомбы
¬орман	Ѕорман
вра-з≥л≥≥	браз≥л≥≥
брата-м≥	братам≥
брат-н≥х	братн≥х
брат-н€й	братн€й
бра-тоҐ	братоҐ
бра-ту	брату
бра-шур	брашур
ЅроҐкв	ЅроҐка
¬роҐка	ЅроҐка
брыга-д	брыгад
брыга-да	брыгада
брыга-дзе	брыгадзе
брыга-ды	брыгады
брыгалы	брыгады
брыгвды	брыгады
брыглды	брыгады
бры-л€	брыл€
Ѕрэснкага	Ѕрэсцкага
брэсц-кай	брэсцкай
всср	бсср
бу-даваҐ	будаваҐ
буда-ваць	будаваць
бу-даҐн≥ка	будаҐн≥ка
булаҐн≥к≥	будаҐн≥к≥
бу-даҐн≥коҐ	будаҐн≥коҐ
будаҐн≥-коҐ	будаҐн≥коҐ
будвҐн≥коҐ	будаҐн≥коҐ
будвҐн≥-коҐ	будаҐн≥коҐ
будаҐн≥нтва	будаҐн≥цтва
будаҐн≥цгва	будаҐн≥цтва
будаҐн≥цтаа	будаҐн≥цтва
будаҐ-н≥цтаа	будаҐн≥цтва
бу-даҐн≥цтва	будаҐн≥цтва
будаҐ-н≥цтва	будаҐн≥цтва
будаҐн≥-цтва	будаҐн≥цтва
будаҐн≥ц-тва	будаҐн≥цтва
будаҐн≥цтвв	будаҐн≥цтва
будаҐн≥цтна	будаҐн≥цтва
будаҐп≥цтва	будаҐн≥цтва
булаҐн≥цтва	будаҐн≥цтва
будаҐ-н≥цтве	будаҐн≥цтве
будаҐн≥цтвс	будаҐн≥цтве
будаҐ-н≥чага	будаҐн≥чага
бу-даҐн≥чы€	будаҐн≥чы€
будае	будзе
бу-дзе	будзе
будзс	будзе
будэе	будзе
бу-дэе	будзе
булзе	будзе
бу-лзе	будзе
бу-дзем	будзем
будзсм	будзем
бу-дэем	будзем
бу-дзеш	будзеш
бу-доҐл≥	будоҐл≥
булоҐл≥	будоҐл≥
бу-доҐл€х	будоҐл€х
буд-трэста	будтрэста
бу-дуе	будуе
будуем-с€	будуемс€
будунь	будуць
бу-дуць	будуць
булуць	будуць
буду-чае	будучае
бу-дучын≥	будучын≥
булучын≥	будучын≥
бу-дучыню	будучыню
будучы-ню	будучыню
будучы-н€	будучын€
бу-дучых	будучых
будукшь	будуюць
буду-юць	будуюць
бу-дынак	будынак
буды-нак	будынак
бу-дынка	будынка
бу-дынкаҐ	будынкаҐ
будын-каҐ	будынкаҐ
булынкаҐ	будынкаҐ
бу-дынку	будынку
будын-ку	будынку
буй-нейшае	буйнейшае
буйней-шых	буйнейшых
бу-лаҐка	булаҐка
бу-ракоҐ	буракоҐ
бураҐ-к≥на	бураҐк≥на
бур-жуазна€	буржуазна€
буржу-азным	буржуазным
буржуаз-ных	буржуазных
буржу-азны€	буржуазны€
бур-ны€	бурны€
¬урны€	Ѕурны€
Ѕ”“ј ќ”	ЅутакоҐ
бм	бы
бь≥	бы
быаае	бывае
бы-вае	бывае
бывас	бывае
бываюпь	бываюць
бы-ваюць	бываюць
бы-ла	была
былв	была
былл	была
был€	была
бы-л≥	был≥
бмло	было
бы-ло	было
бы-лы	былы
бы-лых	былых
бмҐ	быҐ
быу	быҐ
бь≥Ґ	быҐ
бы≥шам	быццам
бынцам	быццам
быцнам	быццам
быц-цам	быццам
быцц€м	быццам
быш≥ам	быццам
бмць	быць
бынь	быць
быпь	быць
бьшь	быць
бю-ро	бюро
б€-дзе	б€дзе
б€ду-л≥	б€дул≥
Ѕ€лул≥	Ѕ€дул≥
б€змсж	б€змеж
б€з-межна€	б€змежна€
б€-л≥нскаму	б€л≥нскаму
б€-розаҐскай	б€розаҐскай
б€ру≥ша	б€руцца
б€рэш≥а	б€рэцца
б€с-пек≥	б€спек≥
б€спе-к≥	б€спек≥
б€спрыкладмы	б€спрыкладны
б€спрыклад-ны	б€спрыкладны
б€с-спрэчна	б€сспрэчна
ва-енных	ваенных
ваен-ных	ваенных
важ-насц≥	важнасц≥
важ-на€	важна€
важ-нейшых	важнейшых
ввйну	вайну
вай≥≥ы	вайны
вайнм	вайны
вай-ны	вайны
ввйны	вайны
взйны	вайны
влйны	вайны
в€йны	вайны
в€й-ны	вайны
€айны	вайны
вакалы≥ы€	вакальны€
ва-кол	вакол
вала-ва€	валава€
ва-лавой	валавой
вала-вой	валавой
ва-лакна	валакна
валеры-ка	валерыка
ва-лы	валы
ва-л€	вал€
¬ал€нн≥на	¬ал€нц≥на
вал€н-ц≥на	вал€нц≥на
вал€нц≥-ны	вал€нц≥ны
аам	вам
ва-м≥	вам≥
влннаҐ	ваннаҐ
ван-ны	ванны
ва≥≥ны	вапны
в€рта	варта
ва-ры€нтаҐ	вары€нтаҐ
вары€н-ты	вары€нты
ва-с≥ль	вас≥ль
¬лс≥ль	¬ас≥ль
ва-с≥льев≥ча	вас≥льев≥ча
вачы-ма	вачыма
ввш	ваш
аашу	вашу
веда-ла	ведала
всдал≥	ведал≥
вс-дал≥	ведал≥
аедаҐ	ведаҐ
ве-даҐ	ведаҐ
велаҐ	ведаҐ
всдаҐ	ведаҐ
недаҐ	ведаҐ
веда≥≥ь	ведаць
ве-даць	ведаць
велаць	ведаць
всдаць	ведаць
ве-даю	ведаю
всдаю	ведаю
ведаюнь	ведаюць
ве-даюць	ведаюць
ведвюць	ведаюць
всдаюць	ведаюць
ве-жу	вежу
вел≥зар-нае	вел≥зарнае
ве-л≥зарнай	вел≥зарнай
ве-л≥чна	вел≥чна
всл≥чны	вел≥чны
вел≥ч-ных	вел≥чных
аельм≥	вельм≥
вель-м≥	вельм≥
вольм≥	вельм≥
всльм≥	вельм≥
нельм≥	вельм≥
пельм≥	вельм≥
€ельм≥	вельм≥
венгер-скай	венгерскай
венгры≥	венгры≥
ве-ра	вера
вер€	вера
¬сра	¬ера
аерасн€	верасн€
всрасн€	верасн€
ве-раць	вераць
всрным	верным
аерш	верш
всрш	верш
аерша	верша
всрша	верша
всршам	вершам
аершаҐ	вершаҐ
всршаҐ	вершаҐ
€ершаҐ	вершаҐ
першах	вершах
аершы	вершы
вершм	вершы
всршы	вершы
вср-шы	вершы
¬сры	¬еры
вЄсвк	вЄсак
весе-ла	весела
вЄс-ках	вЄсках
веск≥	вЄск≥
вЄс-к≥	вЄск≥
всск≥	вЄск≥
нЄск≥	вЄск≥
вЄс-цы	вЄсцы
ветэра-наҐ	ветэранаҐ
вечвр	вечар
всчар	вечар
нечар	вечар
всчара	вечара
вечара-м≥	вечарам≥
ве-чары	вечары
веча-ры	вечары
всчары	вечары
нечары	вечары
в≥-давочна	в≥давочна
в≥-даҐ	в≥даҐ
в≥дань	в≥даць
в≥-даць	в≥даць
в≥длць	в≥даць
в≥д€ць	в≥даць
в≥лаць	в≥даць
в≥-лаць	в≥даць
€≥даць	в≥даць
¬≤ктар	¬≥ктар
в≥к-тара	в≥ктара
в≥н-шавал≥	в≥ншавал≥
в≥нша-вал≥	в≥ншавал≥
в≥н-шаванне	в≥ншаванне
в≥н-шую	в≥ншую
в≥н-шуюць	в≥ншуюць
в≥ншу-юць	в≥ншуюць
в≥-таць	в≥таць
в≥-таю	в≥таю
в≥тры-ны	в≥трыны
в≥-цебск	в≥цебск
¬≥цсбск	¬≥цебск
¬≥цсбскага	¬≥цебскага
в≥-цебскай	в≥цебскай
¬≥цебсквй	¬≥цебскай
¬≥цсбскай	¬≥цебскай
¬≥небску	¬≥цебску
вобласн≥	вобласц≥
вобласп≥	вобласц≥
воб-ласц≥	вобласц≥
воблас-ц≥	вобласц≥
вобласц≥-	вобласц≥
воблвсц≥	вобласц≥
вобллсц≥	вобласц≥
воб-ласць	вобласць
вобраэ	вобраз
воб-раэ	вобраз
нобраз	вобраз
€образ	вобраз
аобраза	вобраза
воб-раза	вобраза
вобраэа	вобраза
вобра-зам≥	вобразам≥
во-бразаҐ	вобразаҐ
вобраэаҐ	вобразаҐ
воб-разна€	вобразна€
вобра-зы	вобразы
вобраэы	вобразы
вожыкв	вожыка
возс	возе
возсра	возера
во-зерам	возерам
во≥-наҐ	во≥наҐ
вой-ск≥	войск≥
воклалка	вокладка
вок-ладках	вокладках
воклад-ках	вокладках
вок-ладк≥	вокладк≥
воклад-к≥	вокладк≥
во-кл≥чы	вокл≥чы
вок-ны	вокны
волы≥ы	вольны
воль-ны	вольны
воль-ны€	вольны€
воль-скага	вольскага
во-лю	волю
воныт	вопыт
во-пыт	вопыт
во-пытнаму	вопытнаму
вопы-ту	вопыту
вопыцс	вопыце
во-рагам	ворагам
во-рагам≥	ворагам≥
ворага-м≥	ворагам≥
во-раг≥	вораг≥
во-сем	восем
во-сен≥	восен≥
вост-рую	вострую
вост-ры	востры
аось	вось
нось	вось
аочы	вочы
во-чы	вочы
ву-л≥ца	вул≥ца
вул≥нах	вул≥цах
вул≥-≥≥ы	вул≥цы
вул≥ны	вул≥цы
ву-л≥цы	вул≥цы
вул≥-цы	вул≥цы
нул≥цы	вул≥цы
вус-ны	вусны
ву-чань	вучань
ву-чацца	вучацца
вучац-ца	вучацца
вучнЄҐ-скага	вучнЄҐскага
вуч-н€Ґ	вучн€Ґ
ву-чоны	вучоны
ву-чоным	вучоным
вучо-ным	вучоным
вучо-ным≥	вучоным≥
вучоны-м≥	вучоным≥
вучо-ных	вучоных
вучо-ны€	вучоны€
ву-чыл≥шча	вучыл≥шча
вучыл≥-шча	вучыл≥шча
вучы-л≥шчы	вучыл≥шчы
вучыл≥-шчы	вучыл≥шчы
вучыҐ-с€	вучыҐс€
вучы-цес€	вучыцес€
аучыцца	вучыцца
вучы≥ша	вучыцца
ву-чыцца	вучыцца
вучыц-ца	вучыцца
вучыш≥а	вучыцца
ву-чэнне	вучэнне
вы-бачайце	выбачайце
вы-брал≥	выбрал≥
выбра-нае	выбранае
вы-вучае	вывучае
вы-вучаюць	вывучаюць
выву-чыць	вывучыць
вы-вучэнн€	вывучэнн€
вы-гл€д	выгл€д
выгл€л	выгл€д
вы-гл€дзе	выгл€дзе
выгл€дзс	выгл€дзе
выгл€лу	выгл€ду
выгнан-не	выгнанне
выдавентва	выдавецтва
выда-вецтва	выдавецтва
выдавецт-ва	выдавецтва
выдавсцтва	выдавецтва
вылавецтва	выдавецтва
выланне	выданне
выланн≥	выданн≥
выдапн€	выданн€
выланн€	выданн€
выдан-н€Ґ	выданн€Ґ
выланн€Ґ	выданн€Ґ
выдат-на	выдатна
вылатна	выдатна
вы-датнага	выдатнага
выдатнас	выдатнае
вылатнай	выдатнай
вы-датную	выдатную
аыдатны	выдатны
вы-датны	выдатны
выдат-ны	выдатны
вылатны	выдатны
выдат-ным	выдатным
вы-датным≥	выдатным≥
вы-датных	выдатных
выдат-ных	выдатных
вылатных	выдатных
выеха-л≥	выехал≥
выэваленн€	вызваленн€
выэначыҐ	вызначыҐ
вы-значыҐс€	вызначыҐс€
вый-шаҐ	выйшаҐ
выншаҐ	выйшаҐ
выншла	выйшла
выка-заны	выказаны
вы-казаҐ	выказаҐ
выказань	выказаць
вы-казаць	выказаць
выкаэаць	выказаць
вы-каэвае	выказвае
выказ-валас€	выказвалас€
аыканал≥	выканал≥
выка-нанне	выкананне
выка-наннем	выкананнем
ныкананн≥	выкананн≥
выка-наҐ	выканаҐ
вы-канаҐцаҐ	выканаҐцаҐ
выквнаҐцаҐ	выканаҐцаҐ
выкв-нвҐцвҐ	выканаҐцаҐ
выканань	выканаць
вы-канаць	выканаць
выка-рыстанн€	выкарыстанн€
выкары-станн€	выкарыстанн€
выкарыстань	выкарыстаць
выкары-стаць	выкарыстаць
выкарыстоҐ-ваючы	выкарыстоҐваючы
вы-кладчык	выкладчык
вы-кл≥кал≥	выкл≥кал≥
вык-л≥кал≥	выкл≥кал≥
выкл≥-каюць	выкл≥каюць
выкл≥-каючы	выкл≥каючы
выключ-на	выключна
вы-ключнай	выключнай
выконвас	выконвае
выконвань	выконваць
выкон-ввць	выконваць
вымпе-лы	вымпелы
выму-шаны	вымушаны
вымуша-ны	вымушаны
вымҐшаны	вымушаны
вына-ходцаҐ	вынаходцаҐ
нын≥ку	вын≥ку
выпалках	выпадках
вы-падку	выпадку
выпад-ку	выпадку
ныпадку	выпадку
вы-п≥саны	вып≥саны
выпраба-ванн€Ґ	выпрабаванн€Ґ
вы-пускае	выпускае
выпус-каць	выпускаць
аыпускн≥к≥	выпускн≥к≥
вы-пускн≥к≥	выпускн≥к≥
вы-пускн≥коҐ	выпускн≥коҐ
выпуск-н≥коҐ	выпускн≥коҐ
вы-пуску	выпуску
вы-рабаҐ	вырабаҐ
выра-баҐ	вырабаҐ
вы-разна	выразна
выраз-на	выразна
выраэна	выразна
пыразна	выразна
выраэнасць	выразнасць
вы-рас	вырас
вы-расла	вырасла
вырас-л€	вырасла
вы-расл≥	вырасл≥
вы-рашана	вырашана
вырашань	вырашаць
выра-шаць	вырашаць
вы-рашыл≥	вырашыл≥
вырашы-л≥	вырашыл≥
€ырашыл≥	вырашыл≥
выра-шыҐ	вырашыҐ
выра-шыць	вырашыць
вырашэн-не	вырашэнне
вы-рашэнн€	вырашэнн€
выра-шэнн€	вырашэнн€
вырашэн-н€	вырашэнн€
нырашэнн€	вырашэнн€
вырошчвань	вырошчваць
вы-сакародна€	высакародна€
высака-родных	высакародных
–зслухала	выслухала
высо-ка	высока
пысока	высока
вы-сокай	высокай
высокан	высокай
высоклй	высокай
вы-сок≥	высок≥
вы-сок≥€	высок≥€
высо-к≥€	высок≥€
высот-най	высотнай
выстаҐкл	выстаҐка
вы-стаҐк≥	выстаҐк≥
выстлҐк≥	выстаҐк≥
пыстаҐк≥	выстаҐк≥
вы-стаҐны	выстаҐны
выстра≥-л≥с€	выстра≥л≥с€
выстра≥л≥-с€	выстра≥л≥с€
вы-ступае	выступае
выступас	выступае
ныступае	выступае
вы-ступала	выступала
вы-ступал≥	выступал≥
аыступаҐ	выступаҐ
выступань	выступаць
высту-паюць	выступаюць
выступа-юць	выступаюць
выстул≥л≥	выступ≥л≥
высту-п≥л≥	выступ≥л≥
аысту-п≥Ґ	выступ≥Ґ
вмступ≥Ґ	выступ≥Ґ
высту-п≥Ґ	выступ≥Ґ
ныступ≥Ґ	выступ≥Ґ
€ыступ≥Ґ	выступ≥Ґ
выступ≥нь	выступ≥ць
вы-ступ≥ць	выступ≥ць
выступлен-не	выступленне
выступлен-нем	выступленнем
вь≥ступлен-нем	выступленнем
аыступленн≥	выступленн≥
вы-ступленн≥	выступленн≥
выступлен-н≥	выступленн≥
высту-п€ць	выступ€ць
вы-творчага	вытворчага
аытворчасц≥	вытворчасц≥
вытаорчасц≥	вытворчасц≥
вытворчагц≥	вытворчасц≥
вы-творчасц≥	вытворчасц≥
вытвор-часц≥	вытворчасц≥
вытворча-сц≥	вытворчасц≥
вытворчаснь	вытворчасць
вытвор-часць	вытворчасць
выхава-ла	выхавала
выхананню	выхаванню
выхааанн€	выхаванн€
вы-хаванн€	выхаванн€
выхаван-н€	выхаванн€
выха-ду	выхаду
аыходз≥ць	выходз≥ць
вы-ходз≥ць	выходз≥ць
ныходз≥ць	выходз≥ць
выходз€нь	выходз€ць
выхоҐ-вае	выхоҐвае
вы-хоҐваць	выхоҐваць
вы-хоҐваюць	выхоҐваюць
вышдй	вышай
вы-ше	выше
вы-шэй	вышэй
вышэй-шую	вышэйшую
вы-шэйшы€	вышэйшы€
вы€в≥нь	вы€в≥ць
вы€Ґл€е≥ша	вы€Ґл€ецца
в€-дзе	в€дзе
в€дзецна	в€дзецца
а€дома	в€дома
вндома	в€дома
в€-дома	в€дома
¬€домв	¬€дома
в€-домв	в€дома
в€домл	в€дома
в€дом€	в€дома
¬€лома	¬€дома
в€лома	в€дома
в€-домага	в€домага
в€ломай	в€домай
в€ломы	в€домы
в€-домых	в€домых
в€дунь	в€дуць
в€-ла	в€ла
в€-л≥	в€л≥
а€л≥кага	в€л≥кага
в€-л≥кага	в€л≥кага
в€л≥-кага	в€л≥кага
в€л≥ка-га	в€л≥кага
в€л≥к€га	в€л≥кага
п€л≥кага	в€л≥кага
в€-л≥кае	в€л≥кае
в€л≥-кае	в€л≥кае
в€л≥кас	в€л≥кае
а€л≥кай	в€л≥кай
в€л≥ка≥≥	в€л≥кай
в€-л≥кай	в€л≥кай
в€л≥-кай	в€л≥кай
в€л≥кан	в€л≥кай
в€л≥квй	в€л≥кай
в€-л≥квй	в€л≥кай
¬€л≥клй	¬€л≥кай
в€л≥клй	в€л≥кай
в€л≥к€й	в€л≥кай
н€л≥кай	в€л≥кай
п€л≥кай	в€л≥кай
в€-л≥каму	в€л≥каму
в€л≥-ка€	в€л≥ка€
¬€л≥кв€	в€л≥ка€
в€л≥кв€	в€л≥ка€
в€л≥кл€	в€л≥ка€
в€-л≥к≥	в€л≥к≥
в€л≥-к≥	в€л≥к≥
п€л≥к≥	в€л≥к≥
€€л≥к≥	в€л≥к≥
а€л≥к≥м	в€л≥к≥м
в€-л≥к≥м	в€л≥к≥м
в€л≥-к≥м	в€л≥к≥м
п€л≥к≥м	в€л≥к≥м
в€-л≥к≥м≥	в€л≥к≥м≥
а€л≥к≥х	в€л≥к≥х
в€-л≥к≥х	в€л≥к≥х
в€-л≥к≥€	в€л≥к≥€
в€л≥-к≥€	в€л≥к≥€
в€л≥-кую	в€л≥кую
в€л≥-ную	в€л≥кую
п€л≥кую	в€л≥кую
€€л≥кую	в€л≥кую
в€р-нул≥с€	в€рнул≥с€
в€рнул≥-с€	в€рнул≥с€
в€р-нуҐс€	в€рнуҐс€
в€р-нуҐшыс€	в€рнуҐшыс€
в€р-нуцца	в€рнуцца
в€р-тацца	в€ртацца
в€рхоунага	в€рхоҐнага
в€р-хоҐнага	в€рхоҐнага
в€рхоҐ-нага	в€рхоҐнага
в€сслы	в€сЄлы
в€-сслы	в€сЄлы
в€с-на	в€сна
в€сн€	в€сна
а€сну	в€сну
в€чэр-нюю	в€чэрнюю
в€-чэрн€й	в€чэрн€й
в€чэр-н€й	в€чэрн€й
га-варылас€	гаварылас€
гавары-лас€	гаварылас€
гава-рыл≥	гаварыл≥
гавары-л≥	гаварыл≥
га-варыҐ	гаварыҐ
гава-рыҐ	гаварыҐ
гав€рыҐ	гаварыҐ
гапарыҐ	гаварыҐ
гаварынь	гаварыць
ганарыць	гаварыць
гаворань	гавораць
гаво-раць	гавораць
гавор-ка	гаворка
гавор-к≥	гаворк≥
г€ворку	гаворку
гаво-рым	гаворым
гаворыш≥а	гаворыцца
гааорыць	гаворыць
гаворынь	гаворыць
га-ворыць	гаворыць
гаво-рыць	гаворыць
гаворьшь	гаворыць
га-ворьшь	гаворыць
га-норыць	гаворыць
га€орыць	гаворыць
г€ворыць	гаворыць
гага-рын	гагарын
га-га-рын	гагарын
“агарын	√агарын
га-гарына	гагарына
гага-рына	гагарына
гагары-на	гагарына
гагарын-а	гагарына
га-гарыну	гагарыну
гага-рыну	гагарыну
гагары-ну	гагарыну
гагары-ным	гагарыным
га-дав≥най	гадав≥най
гада-в≥ны	гадав≥ны
га-давы	гадавы
га-дз≥н	гадз≥н
гадэ≥н	гадз≥н
га-дэ≥н	гадз≥н
глдз≥н	гадз≥н
гл-дэ≥н	гадз≥н
га-дэ≥на	гадз≥на
га-дз≥ны	гадз≥ны
гадэ≥ны	гадз≥ны
га-доҐ	гадоҐ
√адуноу	√адуноҐ
гадм	гады
га-ды	гады
гвды	гады
г€ды	гады
га-зета	газета
газетл	газета
газста	газета
га-эета	газета
газет-ных	газетных
га-зету	газету
газсту	газету
гаэету	газету
газегы	газеты
га-зеты	газеты
газе-ты	газеты
газсты	газеты
газене	газеце
газецо	газеце
газецс	газеце
гаэу	газу
га-лава	галава
га-ласы	галасы
гал≥нс	гал≥не
гвл≥не	гал≥не
галоҐ-нага	галоҐнага
гвлоҐквгв	галоҐнага
га-лоҐнае	галоҐнае
галоҐ-нае	галоҐнае
галоҐ-на€	галоҐна€
гвлоҐны	галоҐны
га-лоҐным	галоҐным
галоҐ-ным	галоҐным
г€лоҐным	галоҐным
га-лоҐны€	галоҐны€
галь-штук	гальштук
га-л€	гал€
га-нарымс€	ганарымс€
гана-рыцца	ганарыцца
ганллю	гандлю
га-небную	ганебную
ган-чарэнка	ганчарэнка
гара-дах	гарадах
гара-лах	гарадах
гаралок	гарадок
га-радоҐ	гарадоҐ
гара-доҐ	гарадоҐ
гаралоҐ	гарадоҐ
г€радоҐ	гарадоҐ
гарад-ска€	гарадска€
га-радск≥м	гарадск≥м
га-радскога	гарадскога
гарадскогл	гарадскога
гаралскога	гарадскога
га-рады	гарады
гара-ды	гарады
гара-чую	гарачую
гарынь	гарыць
гаспалар	гаспадар
гаспа-дарка	гаспадарка
гаснадарк≥	гаспадарк≥
гас-падарк≥	гаспадарк≥
гаспа-дарк≥	гаспадарк≥
гаспадар-к≥	гаспадарк≥
гаспаларк≥	гаспадарк≥
гас-паларк≥	гаспадарк≥
гаспвдарк≥	гаспадарк≥
гас-пвдврк≥	гаспадарк≥
гаспа-дароҐ	гаспадароҐ
гаснадарцы	гаспадарцы
гаспа-дарцы	гаспадарцы
гаспа-дарчым	гаспадарчым
гаспа-дары	гаспадары
гаспада-ры	гаспадары
гаспа-дын€	гаспадын€
глстрол≥	гастрол≥
гастроль-на€	гастрольна€
гвстроль-нв€	гастрольна€
га-стрытах	гастрытах
гас-цей	гасцей
гвсцей	гасцей
га-сц€м≥	гасц€м≥
гато-вы	гатовы
гв≥нс≥	гв≥не≥
геа-граф≥чных	геаграф≥чных
гек-тараҐ	гектараҐ
гекта-раҐ	гектараҐ
√енадэь	√енадзь
генсральны	генеральны
гене-ральным	генеральным
генераль-ным	генеральным
ген≥-€льнай	ген≥€льнай
ген≥-€льны	ген≥€льны
√сорг≥й	√еорг≥й
гера≥-ню	гера≥ню
ге-ра≥чнага	гера≥чнага
ге-ра≥чных	гера≥чных
гера-≥чных	гера≥чных
гера≥ч-ных	гера≥чных
√срман≥≥	√ерман≥≥
гер-ман≥ю	герман≥ю
гер-манск≥м	германск≥м
ге-ро≥	геро≥
гсро≥	геро≥
ге-рой	герой
√срой	√ерой
ге-рою	герою
√ерол	геро€
ге-ро€	геро€
гсро€	геро€
геро€касманаҐта	геро€-касманаҐта
гсро€м≥	геро€м≥
геро-€Ґ	геро€Ґ
гсро€Ґ	геро€Ґ
гс-ро€Ґ	геро€Ґ
г≥-ганцк≥	г≥ганцк≥
г≥-старычнай	г≥старычнай
г≥ста-рычна€	г≥старычна€
г≥старыч-на€	г≥старычна€
г≥-старычных	г≥старычных
г≥с-тарычных	г≥старычных
г≥ста-рычны€	г≥старычны€
г≥старыч-ны€	г≥старычны€
г≥-сторы≥	г≥сторы≥
г≥с-торы≥	г≥сторы≥
г≥сто-ры≥	г≥сторы≥
г≥-сторыю	г≥сторыю
г≥-сторы€	г≥сторы€
г≥сто-ры€	г≥сторы€
г≥сторы-€й	г≥сторы€й
г≥тле-раҐск≥м	г≥тлераҐск≥м
г≥тле-раҐцам≥	г≥тлераҐцам≥
г≥т-лераҐцаҐ	г≥тлераҐцаҐ
г≥т-лераҐцы	г≥тлераҐцы
глеб-ка	глебка
гле-дача	гледача
гледа-ча	гледача
гледа-чам≥	гледачам≥
глелачам≥	гледачам≥
глелачоҐ	гледачоҐ
гледа-чу	гледачу
гле-дачы	гледачы
глелачы	гледачы
глсдачы	гледачы
гл≥-ны	гл≥ны
глы-бока	глыбока
глыбо-ка	глыбока
гл€-дзець	гл€дзець
гл€-дз≥це	гл€дз≥це
гл€дз€нь	гл€дз€ць
гл€-дэ€ць	гл€дз€ць
гн€зло	гн€здо
го-да	года
годв	года
го-дзе	годзе
годзс	годзе
годэе	годзе
годна-сц≥	годнасц≥
годнас-ц≥	годнасц≥
*√олас	√олас
го-лас	голас
≥олас	голас
го-ласам	голасам
го-лым≥	голым≥
√ольцћ≥лера	√ольц-ћ≥лера
√омел≤	√омел≥
го-мельскага	гомельскага
гомельска-га	гомельскага
√омсльскага	√омельскага
го-мельск≥м	гомельск≥м
го-мельск≥х	гомельск≥х
гомельшчы-ны	гомельшчыны
го-нар	гонар
гонвр	гонар
гона-рам	гонарам
гонвру	гонару
гон-цы	гонцы
го-рад	горад
горал	горад
горвд	горад
горлд	горад
го-рада	горада
гора-да	горада
горадв	горада
горад€	горада
горала	горада
го-рала	горада
гора-ла	горада
горвда	горада
горлда	горада
го-радам	горадам
го-радзе	горадзе
гора-дзе	горадзе
горадзс	горадзе
горадэе	горадзе
гордас-цю	гордасцю
гор-кага	горкага
горка-га	горкага
√оркагл	√оркага
≤'оркага	√оркага
гор-к≥	горк≥
госн≥	госц≥
госнь	госць
гос-ц€	госц€
грама-дз€н≥на	грамадз€н≥на
грамадз€-н≥на	грамадз€н≥на
грамадз€н-скага	грамадз€нскага
гра-мадз€нскай	грамадз€нскай
грамадз€н-скай	грамадз€нскай
гра-мадскага	грамадскага
грамад-скага	грамадскага
грамадска-га	грамадскага
грамалскага	грамадскага
грамад-скай	грамадскай
грамадскаснь	грамадскасць
гра-мадскасцю	грамадскасцю
гра-мадска€	грамадска€
гра-мадск≥	грамадск≥
гра-мадск≥м	грамадск≥м
грамад-ск≥м	грамадск≥м
грамалск≥х	грамадск≥х
грлмадск≥х	грамадск≥х
грамалск≥€	грамадск≥€
грамад-скую	грамадскую
грамадстаа	грамадства
гра-мадства	грамадства
грамад-ства	грамадства
грамадстна	грамадства
грлмад-ства	грамадства
грамадствс	грамадстве
грана-тай	гранатай
гранды-Єзны€	грандыЄзны€
гран≥-цы	гран≥цы
гра-ф≥кам	граф≥кам
гра-ф≥к≥	граф≥к≥
гра-шовым≥	грашовым≥
гро-дзенскага	гродзенскага
√родзснскага	√родзенскага
√родзенск≤	√родзенск≥
гро-дзеншчыны	гродзеншчыны
грод-на	гродна
√роднл	√родна
√ролна	√родна
гро-шай	грошай
гро-шы	грошы
√руэ≥≥	√руз≥≥
грунтоҐ-на	грунтоҐна
гру-пы	групы
гу-барэв≥ч	губарэв≥ч
гурт-коҐ	гурткоҐ
гур-ток	гурток
гутар-к≥	гутарк≥
гу-тарку	гутарку
гутар-ку	гутарку
гу-чанн€	гучанн€
гучвць	гучаць
гучынь	гучыць
гїта	гэта
гзта	гэта
гэга	гэта
гэ-та	гэта
гэтв	гэта
гэ-тв	гэта
гэтз	гэта
гэтл	гэта
гэт€	гэта
гэ-т€	гэта
≥эта	гэта
≤'эта	√эта
гзтага	гэтага
гэгага	гэтага
гэ-тага	гэтага
гэта-га	гэтага
гэтагв	гэтага
гэтагл	гэтага
гэтаг€	гэтага
гэтзга	гэтага
гэтлга	гэтага
гэтае	гэтае
гэ-тае	гэтае
гэтле	гэтае
гзтай	гэтай
гэта≥≥	гэтай
гэ-тай	гэтай
гэтан	гэтак
гэта-му	гэтаму
гэ-та€	гэта€
гэтл€	гэта€
гэтм€	гэта€
гэт€€	гэта€
гэ-ту	гэту
гэ-тую	гэтую
гзты	гэты
гэ-ты	гэты
гэть≥	гэты
гзтым	гэтым
гэтмм	гэтым
гэ-тым	гэтым
гзтым≥	гэтым≥
гэ-тым≥	гэтым≥
гзтых	гэтых
гэтмх	гэтых
гэ-тых	гэтых
гзты€	гэты€
гэ-ты€	гэты€
даб≥вайнес€	даб≥вайцес€
да-б≥л≥с€	даб≥л≥с€
дабра-быту	дабрабыту
дабрабы-ту	дабрабыту
давань	даваць
да-ваць	даваць
лаваць	даваць
даведал≥-с€	даведал≥с€
да-ведаҐшыс€	даведаҐшыс€
даведаҐшы-с€	даведаҐшыс€
даве-дацца	даведацца
да-водз≥цца	даводз≥цца
лаводз≥цца	даводз≥цца
да-вол≥	давол≥
дапол≥	давол≥
да€ол≥	давол≥
д€вол≥	давол≥
лавол≥	давол≥
дав€ло-с€	дав€лос€
д€в€лос€	дав€лос€
ла-в€лос€	дав€лос€
да-гавору	дагавору
дагэ-туль	дагэтуль
да-дзены€	дадзены€
да-дому	дадому
ладому	дадому
даз≥роҐ-к≥	даз≥роҐк≥
лаказаҐ	даказаҐ
да-клад	даклад
даклал	даклад
дакла-дам	дакладам
даклалам	дакладам
да-кладна	дакладна
дак-ладна	дакладна
даклална	дакладна
закончыл≥с€	дакончыл≥с€
дак-трыну	дактрыну
даку-менталы≥ы	дакументальны
даку-ментальны	дакументальны
дакумен-тальным	дакументальным
дакумен-тальных	дакументальных
да-кументы	дакументы
дакумен-ты	дакументы
лакументы	дакументы
да-ла	дала
далей-шага	далейшага
лалейшым	далейшым
далей-шых	далейшых
лалЄка	далЄка
далбкае	далЄкае
да-лЄк≥€	далЄк≥€
далЄ-к≥€	далЄк≥€
да-лес	далес
да-леса	далеса
да-л≥	дал≥
дал-лю	даллю
дамагчы-с€	дамагчыс€
дамннструюцца	даманструюцца
да-мах	дамах
да-моҐ	дамоҐ
ламоҐ	дамоҐ
л€моҐ	дамоҐ
да-мы	дамы
да-памагае	дапамагае
дапамагас	дапамагае
дапа-магал≥	дапамагал≥
лапамагал≥	дапамагал≥
двпвмвгвць	дапамагаць
дапамага-юць	дапамагаюць
данамагчы	дапамагчы
да-памагчы	дапамагчы
дапамаг-чы	дапамагчы
да-памога	дапамога
да-памогай	дапамогай
дапа-могай	дапамогай
данамогу	дапамогу
да-памогу	дапамогу
дапа-могу	дапамогу
дапамо-гу	дапамогу
двпвмогу	дапамогу
дапа-можа	дапаможа
да-памозе	дапамозе
да-раг≥€	дараг≥€
дара-г≥€	дараг≥€
дара-гое	дарагое
дарадчы-кам	дарадчыкам
да-рог	дарог
даро-га	дарога
ларога	дарога
даро-гах	дарогах
да-рогу	дарогу
да-розе	дарозе
дарэ-чы	дарэчы
ƒ€рэчы	ƒарэчы
даследа-ванн≥	даследаванн≥
даследаван-н≥	даследаванн≥
дасле-даванн€Ґ	даследаванн€Ґ
да-статкова	дастаткова
да-стаҐлены	дастаҐлены
дастой-най	дастойнай
длстойнай	дастойнай
да-стойную	дастойную
дастой-ную	дастойную
дас€г-ненне	дас€гненне
дас€г-неннем	дас€гненнем
да-с€гненн≥	дас€гненн≥
дас€г-ненн≥	дас€гненн≥
дас€г-ненн€Ґ	дас€гненн€Ґ
двс€гненн€Ґ	дас€гненн€Ґ
лас€гненн€Ґ	дас€гненн€Ґ
дас€г-нул≥	дас€гнул≥
датычьшь	датычыць
даҐ-но	даҐно
лаҐно	даҐно
да-ходаҐ	даходаҐ
да-ходз≥ць	даходз≥ць
даюнь	даюць
ла€рка	да€рка
да€р-кай	да€ркай
даа	два
дватры	два-тры
двацца-ц≥	дваццац≥
двац-цаць	дваццаць
лвор	двор
лвух	двух
дзвсры	дзверы
дэвюх	дзвюх
дзс	дзе
дэе	дзе
лзе	дзе
дзейнасн≥	дзейнасц≥
дзей-насн≥	дзейнасц≥
дзейна-сц≥	дзейнасц≥
дзейнвсц≥	дзейнасц≥
дзейпасц≥	дзейнасц≥
дэейнасц≥	дзейнасц≥
дзе≥≥насць	дзейнасць
дзейнаснь	дзейнасць
дзейнвсць	дзейнасць
дэейнасць	дзейнасць
дзе-л€	дзел€
дзсл€	дзел€
дэЄн	дзЄн
дзснь	дзень
дэень	дзень
лзень	дзень
дзе-с€ткаҐ	дзес€ткаҐ
дзе-с€тк≥	дзес€тк≥
дэес€тк≥	дзес€тк≥
дзес€н≥	дзес€ц≥
дзес€нь	дзес€ць
дзе-ц≥	дзец≥
дэец≥	дзец≥
дзе-ц€м	дзец€м
дзс€ча	дзе€ча
дзе€-чоҐ	дзе€чоҐ
дзс€чоҐ	дзе€чоҐ
дзе€-чы	дзе€чы
дз≥н€	дз≥ц€
дз≥ц€-чага	дз≥ц€чага
дз≥ц€ча-га	дз≥ц€чага
дз≥ц€чан	дз≥ц€чай
дз≥н€чым	дз≥ц€чым
дз≥-ц€чых	дз≥ц€чых
дз≥-ц€чы€	дз≥ц€чы€
дзм≥т-рый	дзм≥трый
дз€-куй	дз€куй
дз€-кую	дз€кую
дэ€кую	дз€кую
дз€-куючы	дз€куючы
ƒэ€н≥саҐ	ƒз€н≥саҐ
дз€р-жава	дз€ржава
дз€ржа-ву	дз€ржаву
дз€р-жавы	дз€ржавы
дз€ржа-вы	дз€ржавы
да€рзкаҐнага	дз€ржаҐнага
ƒэ€ржаҐнага	ƒз€ржаҐнага
дз€р-жаҐнае	дз€ржаҐнае
дз€ржаҐ-нае	дз€ржаҐнае
дз€р-жаҐнай	дз€ржаҐнай
дз€ржаҐ-най	дз€ржаҐнай
дз€р-жаҐна€	дз€ржаҐна€
дз€р-жаҐны	дз€ржаҐны
дз€р-жаҐным	дз€ржаҐным
дз€ржаҐ-ным	дз€ржаҐным
ƒэ€ржаҐным	ƒз€ржаҐным
дз€ржаҐ-ных	дз€ржаҐных
лз€р-жаҐны€	дз€ржаҐны€
ƒэ€ржынскага	ƒз€ржынскага
ƒз€тллҐ	ƒз€тлаҐ
дз€Ґ-чат	дз€Ґчат
дз€Ґчвт	дз€Ґчат
дз€Ґча-ты	дз€Ґчаты
ƒз€учыь	дз€Ґчын
дз€Ґ-чына	дз€Ґчына
ƒэ€Ґчына	ƒз€Ґчына
дз€Ґ-чынка	дз€Ґчынка
ƒэ€Ґчынка	ƒз€Ґчынка
дз€Ґ-чынк≥	дз€Ґчынк≥
дз€Ґчы-ну	дз€Ґчыну
дз€Ґ-чыны	дз€Ґчыны
дз€Ґчы-ны	дз€Ґчыны
дз€ней	дз€цей
дз€-ней	дз€цей
дз€-цей	дз€цей
дз€цсй	дз€цей
дз€-цсй	дз€цей
дэ€цей	дз€цей
лз€цей	дз€цей
дз€н≥нства	дз€ц≥нства
д≥≥€	дл€
длн	дл€
лл€	дл€
лнЄм	днЄм
лн≥	дн≥
лн€	дн€
доб-ра	добра
ƒобрл	ƒобра
добрл	добра
добр€	добра
лобра	добра
добрас	добрае
лобрай	добрай
добраҐпарадка-ванню	добраҐпарадкаванню
доб-ра€	добра€
доб-рую	добрую
доб-ры	добры
лобры	добры
доб-рым	добрым
доб-рым≥	добрым≥
доб-рых	добрых
лобрых	добрых
до-гл€ду	догл€ду
дожлж	дождж
док-тар	доктар
локтар	доктар
дола-раҐ	долараҐ
до-ма	дома
домв	дома
домл	дома
дом€	дома
до-ме	доме
ƒомс	ƒоме
доҐгв	доҐга
доҐта	доҐга
лоҐг≥	доҐг≥
дра-матург	драматург
лраматург	драматург
драма-тургаҐ	драматургаҐ
дра-матург≥	драматург≥
драма-тург≥	драматург≥
дра-матург≥≥	драматург≥≥
лр€-м€тург≥≥	драматург≥≥
драма-тычны	драматычны
дрв-мвтычны	драматычны
драҐл€-ных	драҐл€ных
драҐн≥-ны	драҐн≥ны
друт≥	друг≥
лруг≥	друг≥
дру-г≥м	друг≥м
лруг≥м	друг≥м
дру-г≥€	друг≥€
лруг≥€	друг≥€
другогв	другога
дру-гой	другой
друж-ба	дружба
лружба	дружба
друкар-н≥	друкарн≥
лруку	друку
друкуюццв	друкуюцца
лрэва	дрэва
дрэ-вы	дрэвы
лрэвы	дрэвы
дрэн-на	дрэнна
дрзҐ	дрэҐ
лрэҐ	дрэҐ
ду-б≥нка	дуб≥нка
ƒубоаы	ƒубовы
дуб-рава	дубрава
дуброҐ-скага	дуброҐскага
ду-мак	думак
лумак	думак
лу-мала	думала
дума-л≥	думал≥
думань	думаць
думк€	думка
лумка	думка
дум-кай	думкай
дум-кам≥	думкам≥
дум-к≥	думк≥
лумк≥	думк≥
лумку	думку
дур-ману	дурману
дур-н≥ца	дурн≥ца
ду-хоҐных	духоҐных
ду-хоҐны€	духоҐны€
ду-шой	душой
ду-шу	душу
душм	душы
лушы	душы
ды-в≥з≥≥	дыв≥з≥≥
ды-в≥з≥€	дыв≥з≥€
лык	дык
дырзктар	дырэктар
ды-рэктар	дырэктар
дырэк-тар	дырэктар
лырэктар	дырэктар
лырэктара	дырэктара
лырэкцы€	дырэкцы€
дысцыпл≥-ны	дысцыпл≥ны
дыхан-не	дыханне
дэей-насць	дэейнасць
дэка-мерон	дэкамерон
дэкара-тыҐных	дэкаратыҐных
дэлега-цы≥	дэлегацы≥
дэлега-цы€	дэлегацы€
дэ-макраты≥	дэмакраты≥
дэма-кратычнай	дэмакратычнай
дэман-стравацца	дэманстравацца
дэ-манстрацый	дэманстрацый
дэман-страцы€	дэманстрацы€
дэ-путатам	дэпутатам
дэ-путатаҐ	дэпутатаҐ
дэ-тал≥	дэтал≥
дэта-л€м≥	дэтал€м≥
Є≥≥	Єн
ермачэн-к≥	ермачэнк≥
еснь	есць
≈спь	≈сць
бсць	Єсць
Єс≥≥ь	Єсць
Єснь	Єсць
Єспь	Єсць
ссць	Єсць
еуропы	еҐропы
еҐро-пы	еҐропы
ехань	ехаць
схаць	ехаць
ж€	жа
жа-б≥цк≥	жаб≥цк≥
жадас	жадае
жаданнс	жаданне
жаланне	жаданне
жада-юць	жадаюць
жа-лезнай	жалезнай
∆алеэны	∆алезны
жзль	жаль
жлль	жаль
жано-чага	жаночага
жано-чы	жаночы
жан-чын	жанчын
жан-чына	жанчына
жанчы-на	жанчына
ж€нчына	жанчына
жанчы-ны	жанчыны
жда-нава	жданава
жомка	жонка
жон-ка	жонка
жонкл	жонка
жон-ку	жонку
жонны	жонцы
∆оуты	∆оҐты
жмве	жыве
жывс	жыве
жывЄлага-доҐл≥	жывЄлагадоҐл≥
жывЄла-гадоҐчых	жывЄлагадоҐчых
жывЄлага-доҐчых	жывЄлагадоҐчых
жывЄ-лы	жывЄлы
жы-веш	жывеш
жы-вога	жывога
жывос	жывое
жы-вуць	жывуць
жы€уць	жывуць
жы-вы	жывы
жы-лых	жылых
жыха-ры	жыхары
жыхвры	жыхары
жмццЄ	жыццЄ
жы≥шЄ	жыццЄ
жыннЄ	жыццЄ
жынцЄ	жыццЄ
жыц≥≥Є	жыццЄ
жыцнЄ	жыццЄ
жыццб	жыццЄ
жыцце	жыццЄ
жыц-цЄ	жыццЄ
жыццс	жыццЄ
жыш≥Є	жыццЄ
жь≥ццЄ	жыццЄ
жьшцЄ	жыццЄ
жыццЄ-вага	жыццЄвага
жыц-цЄвым	жыццЄвым
жыццЄ-вых	жыццЄвых
жыш≥Євых	жыццЄвых
жы≥шЄм	жыццЄм
жыннЄм	жыццЄм
жынцЄм	жыццЄм
жыц-цЄм	жыццЄм
жы≥≥ц≥	жыцц≥
жы≥ш≥	жыцц≥
жыцн≥	жыцц≥
жыц-ц≥	жыцц≥
жыш≥≥	жыцц≥
жмцц€	жыцц€
жы≥≥ц€	жыцц€
жы≥ш€	жыцц€
жынн€	жыцц€
жынц€	жыцц€
жыц≥≥€	жыцц€
жыцн€	жыцц€
жыцп€	жыцц€
жыццв	жыцц€
жыц-ц€	жыцц€
жыш≥€	жыцц€
жыц-ц€м≥	жыцц€м≥
жыцц€-радасную	жыцц€радасную
жынь	жыць
жыпь	жыць
3	з
эа	за
заа-парку	заапарку
за-атэхн≥к	заатэхн≥к
за-барону	забарону
за-будову	забудову
забудо-ву	забудову
забу-довы	забудовы
з€-будовы	забудовы
забывань	забываць
заб€спечынь	заб€спечыць
за-б€спечыць	заб€спечыць
заб€спе-чыць	заб€спечыць
эаб€спечыць	заб€спечыць
за-вод	завод
завол	завод
эавод	завод
эа-вод	завод
за-вода	завода
заво-да	завода
завола	завода
запода	завода
злвода	завода
эавода	завода
эа-вода	завода
заво-даҐ	заводаҐ
эаводаҐ	заводаҐ
эаводах	заводах
заводзс	заводзе
эаводзе	заводзе
за-водск≥х	заводск≥х
эаводск≥х	заводск≥х
за-воды	заводы
#»ћя?	загаварыл≥
зага-варыҐ	загаварыҐ
эагаду	загаду
за-гадчык	загадчык
эагадчык	загадчык
за-гадчыка	загадчыка
эагалчыка	загадчыка
загадчына	загадчыца
загад-чыца	загадчыца
эагадчыца	загадчыца
загалоҐ-кам	загалоҐкам
за-г≥нул≥	заг≥нул≥
задавалы≥еннем	задавальненнем
за-даволены	задаволены
зада-волены	задаволены
задаво-лены	задаволены
за-дадзеным	зададзеным
зададзе-ным	зададзеным
эаданне	заданне
за-данн€	заданн€
за-дач	задач
залач	задач
залача	задача
эадача	задача
за-дачай	задачай
за-дачу	задачу
эадачу	задачу
за-дачы	задачы
зада-чы	задачы
эадачы	задачы
задумс	задуме
эадумы	задумы
эайку	зайку
займас	займае
эаймаецца	займаецца
займаюнь	займаюць
займа-юць	займаюць
заканчвас	заканчвае
«аканчэннс	«аканчэнне
заканчэн-н€	заканчэнн€
эакл≥-ку	закл≥ку
за-ключэнне	заключэнне
заключэн-не	заключэнне
эаключэнне	заключэнне
эакона	закона
эаконаҐ	законаҐ
закон-чан	закончан
эакончыла	закончыла
за-ла	зала
залсжыць	залажыць залежыць
эалатым	залатым
зв-ле	зале
залежынь	залежыць
зале-жынь	залежыць
за-л≥чыць	зал≥чыць
эалу	залу
эамежных	замежных
заме-ны	замены
замсст	замест
за-мсст	замест
эамест	замест
за-муж	замуж
заналта	занадта
эан€ткаҐ	зан€ткаҐ
эан€тк≥	зан€тк≥
зан€-ты	зан€ты
за-паветна€	запаветна€
#»ћя?	запаветы
запа-лам	запалам
запатрабаван-н≥	запатрабаванн≥
за-патрабаванн€Ґ	запатрабаванн€Ґ
запэҐн€е	запаҐн€е
за-планавана	запланавана
за-поҐнены	запоҐнены
за-пуск	запуск
за-пусц≥л≥	запусц≥л≥
за-пытала	запытала
за-ра	зара
за-раз	зараз
зараэ	зараз
за-раэ	зараз
эараз	зараз
эараэ	зараз
эарплаты	зарплаты
эарубежных	зарубежных
зару-бежны€	зарубежны€
эаслуг≥	заслуг≥
за-слугоҐвае	заслугоҐвае
за-служанага	заслужанага
эаслужаны	заслужаны
засна-валы≥≥к	заснавальн≥к
засна-вальн≥ка	заснавальн≥ка
заснавальн≥-ка	заснавальн≥ка
за-снавальн≥ку	заснавальн≥ку
застасцца	застаецца
заста-лас€	засталас€
за-стал≥с€	застал≥с€
за-сталос€	засталос€
эасталос€	засталос€
эастаҐс€	застаҐс€
эастаюцца	застаюцца
зата-≥Ґшы	зата≥Ґшы
за-тое	затое
эатое	затое
эатым	затым
эа-тым	затым
эаҐваг≥	заҐваг≥
заҐважынь	заҐважыць
заҐседы	заҐсЄды
заҐ-сЄды	заҐсЄды
заҐсЄ-ды	заҐсЄды
заҐсЄлы	заҐсЄды
заҐссды	заҐсЄды
з€ҐсЄды	заҐсЄды
эаҐсЄды	заҐсЄды
эа-ҐсЄды	заҐсЄды
эаҐ-сЄды	заҐсЄды
заҐтрв	заҐтра
эаҐтра	заҐтра
заҐтраш-н≥	заҐтрашн≥
заха-вал≥с€	захавал≥с€
за-хаванне	захаванне
за-хаванн€	захаванн€
заха-дзе	захадзе
заха-п≥ць	захап≥ць
эахапленне	захапленне
за-хапленнем	захапленнем
захаплен-нем	захапленнем
захап-л€л≥с€	захапл€л≥с€
«ахарааа	«ахарава
заханеҐ	захацеҐ
за-ходн≥х	заходн≥х
заход-н€й	заходн€й
«аходн€н	«аходн€й
за-ходн€€	заходн€€
заход-н€€	заходн€€
эахоҐвае	захоҐвае
захоҐва-л≥с€	захоҐвал≥с€
за-хоҐваҐ	захоҐваҐ
за-€в≥Ґ	за€в≥Ґ
эа€в≥Ґ	за€в≥Ґ
эб≥л≥	зб≥л≥
збл≥-жае	збл≥жае
эбожжа	збожжа
збо-ку	збоку
эбор	збор
эборн≥к	зборн≥к
збор-н≥ка	зборн≥ка
эборн≥ка	зборн≥ка
збор-н≥каҐ	зборн≥каҐ
зборн≥-к≥	зборн≥к≥
эборн≥ку	зборн≥ку
збор-цы	зборцы
эборы	зборы
зважаю-чы	зважаючы
звана-га	званага
зван-не	званне
эванне	званне
эван-не	званне
зва-ны€	званы€
звер-ху	зверху
эвонк≥€	звонк≥€
звы-чайна	звычайна
звычанна	звычайна
эвычайна	звычайна
звы-чайнага	звычайнага
звычай-на€	звычайна€
з€ыш	звыш
эвыш	звыш
зв€-зана	зв€зана
зв€эаны	зв€заны
зв€эа-ны	зв€заны
зв€-заны€	зв€заны€
зв€р-нул≥с€	зв€рнул≥с€
зв€рну-л≥с€	зв€рнул≥с€
зв€р-нуҐс€	зв€рнуҐс€
зв€р-нуць	зв€рнуць
зв€р-таемс€	зв€ртаемс€
зв€ртаеш≥а	зв€ртаецца
зга-дз≥цца	згадз≥цца
злабыткам	здабыткам
зда-валас€	здавалас€
здава-лас€	здавалас€
эдавалас€	здавалас€
здаенца	здаецца
здаец≥≥а	здаецца
зда-ецца	здаецца
здаец-ца	здаецца
«даеш≥а	«даецца
здаеш≥а	здаецца
зда-еш≥а	здаецца
эдал≥	здал≥
зда-роҐ€	здароҐ€
злароҐ€	здароҐ€
эдароҐ€	здароҐ€
зда-рылас€	здарылас€
здары-лас€	здарылас€
эдарылас€	здарылас€
эдз≥Ґлены	здз≥Ґлены
здз€й-сненне	здз€йсненне
здз€йс-ненн€Ґ	здз€йсненн€Ґ
здз€йснен-н€Ґ	здз€йсненн€Ґ
здоле-л≥	здолел≥
здо-леҐ	здолеҐ
злолеҐ	здолеҐ
эдолеҐ	здолеҐ
эдольнасц≥	здольнасц≥
здолы≥ы	здольны
здоль-ны	здольны
эдольны	здольны
эдольны€	здольны€
зды-мак	здымак
эдымак	здымак
здымну	здымку
эдымку	здымку
эдымну	здымку
з'езл	з'езд
з'еэд	з'езд
з'сзд	з'езд
з'ездл	з'езда
з'езла	з'езда
з'еэда	з'езда
з'сзда	з'езда
э'езда	з'езда
э'еэда	з'езда
з'езлу	з'езду
з'еэду	з'езду
э'езду	з'езду
э'еэду	з'езду
зем-л≥	земл≥
эемл€к≥	земл€к≥
эемл€коҐ	земл€коҐ
земл€роб-ства	земл€робства
эерне	зерне
зза	з-за
з≥-хац€ць	з≥хац€ць
злеаа	злева
зл≥-л≥с€	зл≥л≥с€
злу-чаным≥	злучаным≥
злуча-ным≥	злучаным≥
злу-чаных	злучаных
злуча-ны€	злучаны€
змагасцца	змагаецца
эмагаецца	змагаецца
зма-гайцес€	змагайцес€
змагай-цес€	змагайцес€
эмагаҐс€	змагаҐс€
зма-гацца	змагацца
эмагацца	змагацца
зма-гаюцца	змагаюцца
эмагаюцца	змагаюцца
эмагл≥	змагл≥
эмен	змен
эмена	змена
зме-ны	змены
эмены	змены
эмест	змест
эместам	зместам
змес-ту-	зместу
эместу	зместу
зме-шчана	змешчана
змешча-нае	змешчанае
эмешчаны	змешчаны
зм≥тра-ка	зм≥трака
эм€н≥л≥с€	зм€н≥л≥с€
энаЄмства	знаЄмства
знасмы	знаЄмы
энаЄмых	знаЄмых
знайсн≥	знайсц≥
энайсн≥	знайсц≥
энайсц≥	знайсц≥
знай-шла	знайшла
энайшла	знайшла
энайшоҐ	знайшоҐ
знам€наль-ных	знам€нальных
энаходжанн€	знаходжанн€
зна-ходз≥л≥с€	знаходз≥л≥с€
эна-ходз≥Ґс€	знаходз≥Ґс€
знаходз≥ц-ца	знаходз≥цца
знаходз≥ш≥а	знаходз≥цца
энаходз≥цца	знаходз≥цца
эна-ходэ≥цца	знаходз≥цца
знаходз≥нь	знаходз≥ць
знахо-дз≥ць	знаходз≥ць
энаходз€цца	знаходз€цца
знаходз€нь	знаходз€ць
энаходз€ць	знаходз€ць
знач-на	значна
эначна	значна
эначнае	значнае
знач-най	значнай
эначную	значную
«начынь	«начыць
значынь	значыць
зна-чыць	значыць
зна-чьшь	значыць
эна-чыць	значыць
зна-чэнне	значэнне
значэн-не	значэнне
значэннс	значэнне
зна-чэнн€	значэнн€
значэн-н€	значэнн€
эначэнн€	значэнн€
энойдзе	знойдзе
энойдзеш	знойдзеш
эноҐ	зноҐ
эор	зор
эоры	зоры
зпад	з-пад
зра-б≥л≥	зраб≥л≥
эраб≥л≥	зраб≥л≥
эра-б≥л≥	зраб≥л≥
зра-б≥Ґ	зраб≥Ґ
эраб≥Ґ	зраб≥Ґ
зраб≥≥≥ь	зраб≥ць
зраб≥нь	зраб≥ць
зра-б≥ць	зраб≥ць
эраб≥ць	зраб≥ць
зра-зумела	зразумела
зразу-мела	зразумела
зразумсла	зразумела
«раэумела	«разумела
зраэумеҐ	зразумеҐ
зразумень	зразумець
зра-зумець	зразумець
зраэумець	зразумець
эразумець	зразумець
эраэумець	зраэумець
эроб≥ць	зроб≥ць
зроб-лена	зроблена
зробле-на	зроблена
эроблена	зроблена
зробле-ны	зроблены
зроблс-ны	зроблены
эроблены	зроблены
зробле-ны€	зроблены€
зрэд-ку	зрэдку
зу-с≥м	зус≥м
эус≥м	зус≥м
«ЎЋ	«Ўј
з'нв≥Ґс€	з'€в≥Ґс€
з'€в≥ц-ца	з'€в≥цца
з'€в≥ш≥а	з'€в≥цца
з€лЄ-нага	з€лЄнага
з€-лЄным	з€лЄным
з€лЄ-ным≥	з€лЄным≥
э€мель	з€мель
э€мельку	з€мельку
з€м-л≥	з€мл≥
з€мп≥	з€мл≥
≥€мл≥	з€мл≥
э€мл≥	з€мл≥
з€м-лю	з€млю
э€млю	з€млю
«€млюмац≥	«€млю-мац≥
з€м-л€	з€мл€
э€мл€	з€мл€
э€мл€к	з€мл€к
з€м-нога	з€многа
з'€Ґл€е≥ша	з'€Ґл€ецца
з'€Ґл€еп-ца	з'€Ґл€ецца
з'€Ґл€ецна	з'€Ґл€ецца
з'€Ґ-л€ецца	з'€Ґл€ецца
з'€Ґл€ец-ца	з'€Ґл€ецца
з'€Ґл€еш≥а	з'€Ґл€ецца
з'€Ґл€сцца	з'€Ґл€ецца
з'€Ґл€-сцца	з'€Ґл€ецца
≥'€Ґл€ецца	з'€Ґл€ецца
э'€Ґл€ецца	з'€Ґл€ецца
э'€Ґ-л€ецца	з'€Ґл€ецца
з'€Ґ-л€л≥с€	з'€Ґл€л≥с€
з'€Ґ-л€юс€	з'€Ґл€юс€
з'€Ґл€ю≥ша	з'€Ґл€юцца
з'€Ґл€юцна	з'€Ґл€юцца
з'€Ґ-л€юцца	з'€Ґл€юцца
з'€Ґл€юш≥а	з'€Ґл€юцца
э'€Ґл€-юцца	з'€Ґл€юцца
нскусство	искусство
1	≥
≤ввн	≤ван
≤влн	≤ван
≤в€н	≤ван
≤€ан	≤ван
≥ва-на	≥вана
≤влна	≤вана
≤в€на	≤вана
≤в€н€	≤вана
≤нана	≤вана
≥ва-нав≥ч	≥ванав≥ч
≥вана-в≥ч	≥ванав≥ч
≥ванаҐ-на	≥ванаҐна
≤¬јЌќ”	≤ваноҐ
≥грань	≥граць
≥дзс	≥дзе
≥дэе	≥дзе
≥дунь	≥дуць
≥лэй	≥дэй
≥лэ€	≥дэ€
≥ль≥-ча	≥ль≥ча
≥люстраны≥	≥люстрацы≥
≥мЄ-нах	≥мЄнах
≥мены	≥мЄны
≥мкл≥-вы	≥мкл≥вы
≥мк-ненне	≥мкненне
≥мкнен-не	≥мкненне
≥мкненнс	≥мкненне
≥мкнснне	≥мкненне
≥мкнсцца	≥мкнецца
≥мкнуш≥а	≥мкнуцца
≥мпе-ры€л≥зму	≥мперы€л≥зму
≥мперы€-л≥зму	≥мперы€л≥зму
≥м-перы€л≥стаҐ	≥мперы€л≥стаҐ
≥мпе-ры€л≥стаҐ	≥мперы€л≥стаҐ
≥мперы-€л≥стаҐ	≥мперы€л≥стаҐ
≥мпе-ры€л≥стычных	≥мперы€л≥стычных
≤ндак≥тлй	≤ндак≥тай
≥нду-стры≥	≥ндустры≥
≥нду-стры€л≥зацы€	≥ндустры€л≥зацы€
≥ндустры-€льную	≥ндустры€льную
≥н-ды≥	≥нды≥
≥нжы-нер	≥нжынер
≥н-жынера	≥нжынера
≥н-жынерам	≥нжынерам
≥нжыне-рам	≥нжынерам
≥нжы-нерам≥	≥нжынерам≥
≥нжы-нераҐ	≥нжынераҐ
≥нжы-неры	≥нжынеры
≥н≥-цы€тыва	≥н≥цы€тыва
≥н≥ны€тыве	≥н≥цы€тыве
≥н≥цы€-тыве	≥н≥цы€тыве
≥н≥цы€-тыву	≥н≥цы€тыву
≥н≥цы€ты-вы	≥н≥цы€тывы
≥нстру-мент	≥нструмент
≥нсты-тут	≥нстытут
≥м-стытута	≥нстытута
≥н-стытута	≥нстытута
≥нсты-тута	≥нстытута
≥нстыту-та	≥нстытута
≥н-стытуты	≥нстытуты
≥н-стытуне	≥нстытуце
≥н-стытуце	≥нстытуце
≥нсты-туце	≥нстытуце
≥нта-нацый	≥нтанацый
≥нта-рэсаҐ	≥нтарэсаҐ
≥нтарэ-сы	≥нтарэсы
≥нтэл≥генны≥	≥нтэл≥генцы≥
≥нтэл≥-генцы≥	≥нтэл≥генцы≥
≥нтэрвен-таҐ	≥нтэрвентаҐ
≥н-тэрнатах	≥нтэрнатах
≥нтэрнацы€наль-най	≥нтэрнацы€нальнай
≥н-фармацыю	≥нфармацыю
≥нша-га	≥ншага
≥н-шую	≥ншую
≥н-шы	≥ншы
≥н-шым	≥ншым
≥н-шым≥	≥ншым≥
≥ншы-м≥	≥ншым≥
≥≥≥шых	≥ншых
≥н-шых	≥ншых
≥≥≥шы€	≥ншы€
≥н-шы€	≥ншы€
≥ры-на	≥рына
≥с-наванне	≥снаванне
≥с-наванн€	≥снаванн€
≥снус	≥снуе
≥сн≥	≥сц≥
1х	≥х
≥ш-ла	≥шла
≥шл€	≥шла
квб	каб
кзб	каб
клб	каб
к€б	каб
каб≥-нет	каб≥нет
каб≥не-це	каб≥неце
каб-рынца	кабрынца
кабрын-ца	кабрынца
ка-валачку	кавалачку
ка-го	каго
калраҐ	кадраҐ
клжл	кажа
кажунь	кажуць
ка-жуць	кажуць
ка-жучы	кажучы
ка-эан≥	казан≥
каэаҐ	казаҐ
каз-ку	казку
калан≥€-л≥зму	калан≥€л≥зму
ка-лан≥€лы≥ых	калан≥€льных
ка-лачынск≥	калачынск≥
кал-гас	калгас
кал-гаса	калгаса
калгасв	калгаса
кал-гасв	калгаса
калгасл	калгаса
калгас€	калгаса
калга-саҐ	калгасаҐ
кал-гасах	калгасах
калга-сах	калгасах
кал-гасе	калгасе
калга-се	калгасе
калгасс	калгасе
калга-сс	калгасе
калг€се	калгасе
калгас-н≥кам	калгасн≥кам
калгас-н≥каҐ	калгасн≥каҐ
кал-гасн≥к≥	калгасн≥к≥
калгас-н≥к≥	калгасн≥к≥
к€лгасн≥к≥	калгасн≥к≥
калгас-н≥цы	калгасн≥цы
квл-гвсным	калгасным
кал-гасных	калгасных
калгас-ных	калгасных
калг€сных-	калгасных
квлгвсных	калгасных
капег≥€	калег≥€
калек-тываҐ	калектываҐ
калекты-ваҐ	калектываҐ
калсктываҐ	калектываҐ
калектыау	калектыву
ка-лектыву	калектыву
калсктыву	калектыву
ка-лектывы	калектывы
калсктывы	калектывы
калекгыҐ	калектыҐ
ка-лектыҐ	калектыҐ
калек-тыҐ	калектыҐ
калсктыҐ	калектыҐ
ка-лсктыҐ	калектыҐ
кллектыҐ	калектыҐ
к€лектыҐ	калектыҐ
ка-л≥	кал≥
квл≥	кал≥
кзл≥	кал≥
клл≥	кал≥
кэл≥	кал≥
к€л≥	кал≥
кал≥н≥-на	кал≥н≥на
кал≥н≥н-града	кал≥н≥нграда
кал≥сьн≥	кал≥сьц≥
ка-л≥сьц≥	кал≥сьц≥
кал≥сь-ц≥	кал≥сьц≥
ка-лоны	калоны
калн	кал€
ка-л€	кал€
квл€	кал€
клл€	кал€
к€л€	кал€
кал€-ровай	кал€ровай
камандз≥-рам	камандз≥рам
камб≥на-та	камб≥ната
камелы€	камеды€
ка-менем	каменем
каменаломн€х	камен€ломн€х
кам≥сары-€т	кам≥сары€т
кам≥сары€-та	кам≥сары€та
кам≥-с≥ю	кам≥с≥ю
ка-м≥тэт	кам≥тэт
кампаз≥-тар	кампаз≥тар
кам-паз≥тара	кампаз≥тара
кампа-з≥тара	кампаз≥тара
кам-паэ≥тара	кампаз≥тара
кам-паз≥тарам	кампаз≥тарам
кампаз≥та-рам	кампаз≥тарам
кампа-з≥тараҐ	кампаз≥тараҐ
кампаз≥та-раҐ	кампаз≥тараҐ
кампаэ≥тараҐ	кампаз≥тараҐ
камназ≥тары	кампаз≥тары
кампаэ≥цы€й	кампаз≥цы€й
кам-самол	камсамол
кам-самольскай	камсамольскай
кам-самольск≥	камсамольск≥
кам-самольск≥€	камсамольск≥€
камса-молы≥аҐ	камсамольцаҐ
камсамоль-цаҐ	камсамольцаҐ
камсамольны	камсамольцы
квмсвмольцы	камсамольцы
ка-мун≥зм	камун≥зм
каму-н≥зм	камун≥зм
камун≥эм	камун≥зм
ка-мун≥зма	камун≥зма
каму-н≥зма	камун≥зма
камун≥з-ма	камун≥зма
камун≥змв	камун≥зма
камун≥эма	камун≥зма
ка-мун≥эма	камун≥зма
квмун≥эмв	камун≥зма
ка-мун≥ст	камун≥ст
ка-мун≥ста	камун≥ста
каму-н≥стам	камун≥стам
камун≥-стаҐ	камун≥стаҐ
каму-н≥стычнага	камун≥стычнага
камун≥-стычнага	камун≥стычнага
камун≥стыч-нага	камун≥стычнага
камун≥стычнагв	камун≥стычнага
камун≥-стычнае	камун≥стычнае
 амум≥стычнай	 амун≥стычнай
ка-мун≥стычнай	камун≥стычнай
каму-н≥стычнай	камун≥стычнай
камун≥-стычнай	камун≥стычнай
камун≥с-тычнай	камун≥стычнай
камун≥стыч-най	камун≥стычнай
камун≥стычнан	камун≥стычнай
 амун≥стычнвй	 амун≥стычнай
камун≥стычнлй	камун≥стычнай
камун≥стычн€й	камун≥стычнай
камуп≥стычнай	камун≥стычнай
 вмун≥стычнвй	 амун≥стычнай
к€мун≥стыч-най	камун≥стычнай
мун≥стычнай	камун≥стычнай
ка-мун≥стычна€	камун≥стычна€
камун≥стыч-на€	камун≥стычна€
ка-мун≥стычных	камун≥стычных
камун≥стыч-ны€	камун≥стычны€
кам€ненка€	кам€нецка€
ка-напы	канапы
кан-веера	канвеера
кан-дыдатуры	кандыдатуры
канен	канец
кансц	канец
кан-крэтнай	канкрэтнай
кансерва-торы≥	кансерваторы≥
канстан-ц≥н	канстанц≥н
кан-структараҐ	канструктараҐ
канст-руктараҐ	канструктараҐ
кан-тату	кантату
канферэн-цы≥	канферэнцы≥
канфсрэнцы≥	канферэнцы≥
клч-ферэнцы≥	канферэнцы≥
кан-ферэнцыю	канферэнцыю
кан-ферэнцы€	канферэнцы€
камфл≥кт	канфл≥кт
канфл≥к-таҐ	канфл≥ктаҐ
канф-л≥кту	канфл≥кту
канфл≥к-ту	канфл≥кту
кан-фл≥кты	канфл≥кты
кан-цы	канцы
каннэрт	канцэрт
кан-нэрт	канцэрт
канцзрт	канцэрт
кан-цэрт	канцэрт
каннэрта	канцэрта
кан-цэрта	канцэрта
каннэртам≥	канцэртам≥
каннэртаҐ	канцэртаҐ
канцэр-таҐ	канцэртаҐ
квнцэртаҐ	канцэртаҐ
кан-цэртна€	канцэртна€
кап≥тал≥эму	кап≥тал≥зму
ка-п≥тал≥стаҐ	кап≥тал≥стаҐ
кап≥-тал≥стычнага	кап≥тал≥стычнага
кап≥тал≥-стычнай	кап≥тал≥стычнай
кап≥та-л≥стычных	кап≥тал≥стычных
кап≥тал≥-стычных	кап≥тал≥стычных
кап≥-тал≥стычны€	кап≥тал≥стычны€
кап≥тал≥-стычны€	кап≥тал≥стычны€
капыльска-га	капыльскага
квпэлы	капэлы
кап€-люш	кап€люш
ка-рабель	карабель
карабельспадарожн≥к	карабель-спадарожн≥к
караб-лЄҐ	караблЄҐ
ка-рабл≥	карабл≥
ка-рабл€	карабл€
караб-л€	карабл€
карабл€спадарожн≥ка	карабл€-спадарожн≥ка
ка-рабл€х	карабл€х
ка-раюць	караюць
ка-роткай	кароткай
карот-к≥	каротк≥
каротн≥х	каротк≥х
ка-роҐ	кароҐ
кар-ту	карту
кар-ц≥н	карц≥н
карн≥не	карц≥не
кар-ц≥ны	карц≥ны
карыс-ную	карысную
ка-рыстаецца	карыстаецца
кары-стаецца	карыстаецца
карыс-таецца	карыстаецца
карыстаец-ца	карыстаецца
карыстаеш≥а	карыстаецца
ка-рыстаюцца	карыстаюцца
карыс-таюцца	карыстаюцца
клрысць	карысць
ка-рэйскай	карэйскай
ка-рэйскую	карэйскую
ка-рэл≥цкага	карэл≥цкага
кагманаҐта	касманаҐта
касманаҐ-та	касманаҐта
касманаҐ-там	касманаҐтам
касманаҐ-таҐ	касманаҐтаҐ
касманау-ту	касманаҐту
касманаҐ-ту	касманаҐту
кагм≥чнага	касм≥чнага
ка-см≥чнага	касм≥чнага
кас-м≥чнага	касм≥чнага
касм≥чна-га	касм≥чнага
кас-м≥чнай	касм≥чнай
касм≥ч-на€	касм≥чна€
кас-м≥чную	касм≥чную
касм≥ч-ны	касм≥чны
кас-м≥чным	касм≥чным
касм≥ч-ным	касм≥чным
кас-м≥чных	касм≥чных
касм≥ч-ных	касм≥чных
кастрыч-н≥к	кастрычн≥к
кастрыч-н≥ка	кастрычн≥ка
ка-стрычн≥цкага	кастрычн≥цкага
кастрыч-н≥цкай	кастрычн≥цкай
кастрычн≥ц-кай	кастрычн≥цкай
 астрычн≥цкан	 астрычн≥цкай
каст-рычн≥цкую	кастрычн≥цкую
 асгусь	 астусь
кас-тусь	кастусь
касцю-маҐ	касцюмаҐ
каш-курэв≥ч	кашкурэв≥ч
каш-тоҐны€	каштоҐны€
к€штоҐны€	каштоҐны€
квад-ратных	квадратных
квар-тале	квартале
квстк≥	кветк≥
квеце-н≥	квецен≥
кене-дз≥	кенедз≥
к≥Єс-к≥	к≥Єск≥
к≥лагврцаҐ	к≥лагарцаҐ
к≤лагерцаҐ№	к≥лагерцаҐ
к≥лагра-маҐ	к≥лаграмаҐ
к≥-ламетраҐ	к≥ламетраҐ
к≥ламет-ры	к≥ламетры
к≥на-калры	к≥накадры
к≥накал-ры	к≥накадры
к≥нарэ-жысЄр	к≥нарэжысЄр
к≥ннсетк≥	к≥насетк≥
к≥на-студы≥	к≥настуды≥
к≥нас-туды≥	к≥настуды≥
к≥на-тэатры	к≥натэатры
к≥-наф≥льм	к≥наф≥льм
к≥наф≥ль-маҐ	к≥наф≥льмаҐ
к≥наф≥ль-мы	к≥наф≥льмы
к≥-но	к≥но
к≥ра-ваць	к≥раваць
к≥раҐ-н≥ка	к≥раҐн≥ка
к≥раҐн≥нтва	к≥раҐн≥цтва
к≥раҐн≥цтаа	к≥раҐн≥цтва
к≥раҐ-н≥цтва	к≥раҐн≥цтва
к≥раҐ-н≥цтвам	к≥раҐн≥цтвам
к≥раҐн≥цт-вам	к≥раҐн≥цтвам
к≥раҐн≥цтвлм	к≥раҐн≥цтвам
к≥сла-водск	к≥славодск
кла-са	класа
клас≥-каҐ	клас≥каҐ
кло-патаҐ	клопатаҐ
клопа-ту	клопату
кло-паты	клопаты
клопа-ты	клопаты
клу-ба	клуба
клубв	клуба
клубл	клуба
клу-баҐ	клубаҐ
клубвҐ	клубаҐ
клубнвй	клубнай
клуб-ных	клубных
нлуб-ных	клубных
к≥≥≥г	кн≥г
кн≥гв	кн≥га
к≥≥≥г≥	кн≥г≥
нн≥г≥	кн≥г≥
км≥гу	кн≥гу
кн≥ж-на€	кн≥жна€
кн≥эе	кн≥зе
кож-нага	кожнага
кожнагв	кожнага
кожнагз	кожнага
кожнлга	кожнага
кожнан	кожнай
кожнвй	кожнай
кож-нвй	кожнай
кожнлй	кожнай
кожн€й	кожнай
кож-на€	кожна€
кож-ную	кожную
кож≥≥ы	кожны
кожнм	кожны
ко-жны	кожны
кож-ны	кожны
кожнь≥	кожны
кожпы	кожны
кож≥≥ым	кожным
кожмым	кожным
кож-ным	кожным
ко-ласа	коласа
колькасн≥	колькасц≥
колькаснь	колькасць
коль-касць	колькасць
коль-к≥	кольк≥
 оммуннст	 оммунист
ком-плексную	комплексную
кон-курсаҐ	конкурсаҐ
кон-курсе	конкурсе
кон-курсу	конкурсу
контр-удара	контрудара
кор-пуса	корпуса
кос-мас	космас
космлс	космас
носмас	космас
космас≥	космасе
косма-сс	космасе
кос-масу	космасу
косма-су	космасу
космасуЧгэта	космасу - гэта
 √≤——	 ѕ——
 ≤≤——	 ѕ——
кра≥нм	кра≥ам
кра≥п	кра≥н
нра≥н	кра≥н
кра≥нв	кра≥на
кра≥-нам≥	кра≥нам≥
кра≥-нах	кра≥нах
кра-≥не	кра≥не
кра≥нс	кра≥не
крв≥не	кра≥не
кра≥мы	кра≥ны
кра≥-ны	кра≥ны
крвй	край
кра-п≥вы	крап≥вы
крап≥-вы	крап≥вы
крага-в≥ка	красав≥ка
красав≥кв	красав≥ка
нрасав≥ка	красав≥ка
нрасав≥на	красав≥на
кро-кам	крокам
кро-каҐ	крокаҐ
кро-ку	кроку
крык-нуҐ	крыкнуҐ
крын≥ны	крын≥цы
крыты-ка	крытыка
крытыкв	крытыка
крытык€	крытыка
крыты-каваҐ	крытыкаваҐ
крытыны	крытыцы
кры-ху	крыху
кры-чыць	крычыць
крэ-дытах	крэдытах
крэпасн≥	крэпасц≥
крэ-пасц≥	крэпасц≥
крэпаснь	крэпасць
ку-ба	куба
куба-метраҐ	кубаметраҐ
 убннскага	 убанскага
ку-бе	кубе
ку-бу	кубу
ку-бы	кубы
кулы	куды
кузн€цо-ва	кузн€цова
куэьма	кузьма
кузьм≥-ча	кузьм≥ча
куйбы-шава	куйбышава
куку-рузны€	кукурузны€
кукуруэу	кукурузу
кукуруэы	кукурузы
культурм	культура
куль-турай	культурай
культур-ным	культурным
куль-турных	культурных
кудьтуры	культуры
куль-гуры	культуры
куль-туры	культуры
культу-ры	культуры
культурыЧ32054	культуры
культурь≥	культуры
купьтуры	культуры
нультуры	культуры
купалаҐ-цаҐ	купалаҐцаҐ
ку-палу	купалу
 улалы	 упалы
 уналы	 упалы
купа-лы	купалы
 уп€лы	 упалы
ку-рортаҐ	курортаҐ
ку-рорце	курорце
кур-са	курса
кут-ку	кутку
лаба-раторы≥	лабараторы≥
лабара-торы≥	лабараторы≥
ла-бараторы€	лабараторы€
ла-геры	лагеры
лагсры	лагеры
лаг≥-шына	лаг≥шына
лаг≥-шыне	лаг≥шыне
лагой-скага	лагойскага
ла-гун	лагун
Ћдз≥н	Ћаз≥н
ла-мы	ламы
ла-ска	ласка
ла-скава	ласкава
латннскнй	латинский
лац≥н-скай	лац≥нскай
Ћсан≥д	Ћеан≥д
ледэь	ледзь
лекны≥	лекцы≥
лек-цый	лекцый
лек-цыю	лекцыю
ле-н≥н	лен≥н
Ћвн≥на	Ћен≥на
ле-м≥на	лен≥на
ле-н≥на	лен≥на
лен≥-на	лен≥на
ле-€≥на	лен≥на
Ћс≥≥≥на	Ћен≥на
лсн≥на	лен≥на
лс-н≥на	лен≥на
ле-н≥не	лен≥не
≈Ќ≤Ќ≤«ћ	лен≥н≥зм
лен≥-н≥зма	лен≥н≥зма
лен≥н-скага	лен≥нскага
лен≥нска-га	лен≥нскага
Ћсн≥нскага	Ћен≥нскага
ле-н≥нскай	лен≥нскай
лен≥н-ск≥м	лен≥нск≥м
ле-н≥нск≥х	лен≥нск≥х
лен≥н-ск≥х	лен≥нск≥х
ле-н≥ным	лен≥ным
лспш	лепш
леп-шае	лепшае
леп-ша€	лепша€
леп-шы	лепшы
лспшы	лепшы
леп-шым	лепшым
леп-шым≥	лепшым≥
леп-шых	лепшых
лспшых	лепшых
леп-шы€	лепшы€
лспшы€	лепшы€
лес-в≥ца	лесв≥ца
лста	лета
ле-там	летам
ле-тась	летась
лет-н≥	летн≥
лЄтчы-ка	лЄтчыка
лЄтчыкакасманаҐта	лЄтчыка-касманаҐта
Ћнтература	Ћитература
л1	л≥
л≥б-рэта	л≥брэта
л≥нка-вец	л≥нкавец
л≥псн€	л≥пен€
л≥-повы	л≥повы
л≥-рызмам	л≥рызмам
л≥таралы≥а	л≥таральна
I“ј–ј“”–ј	л≥таратура
≥таратура	л≥таратура
Ћ≥тарагура	л≥таратура
л≥-таратура	л≥таратура
л≥та-ратура	л≥таратура
л≥тара-тура	л≥таратура
л≥та-ратурай	л≥таратурай
л≥та-ратурнага	л≥таратурнага
л≥тара-турнага	л≥таратурнага
л≥таратур-нае	л≥таратурнае
л≥таратурнас	л≥таратурнае
л≥тара-турных	л≥таратурных
л≥таратур-ны€	л≥таратурны€
л≥-таратуру	л≥таратуру
л≥тарагуры	л≥таратуры
л≥таратурм	л≥таратуры
л≥-таратуры	л≥таратуры
л≥та-ратуры	л≥таратуры
л≥тара-туры	л≥таратуры
л≥тарату-ры	л≥таратуры
л≥таратурыЧ32204	л≥таратуры
л≥тарвтуры	л≥таратуры
л≥тарзтуры	л≥таратуры
л≥тарлтуры	л≥таратуры
л≥тар€-туры	л≥таратуры
л≥тврвтуры	л≥таратуры
л≥тлратуры	л≥таратуры
л≥-т€ратуры	л≥таратуры
л≥-тоҐскай	л≥тоҐскай
л≥-тоҐск≥м	л≥тоҐск≥м
л≥-чылы≥≥к	л≥чыльн≥к
л≥чыц-ца	л≥чыцца
л≥чынь	л≥чыць
лю-ба€	люба€
лю-б≥мых	люб≥мых
лю-б≥Ґ	люб≥Ґ
люб≥нь	люб≥ць
лю-б≥ць	люб≥ць
лю-бой	любой
лю-боҐю	любоҐю
люб€нь	люб€ць
людаей	людзей
людзе≥≥	людзей
лю-дзей	людзей
людзен	людзей
людзсй	людзей
людэей	людзей
лю-дэей	людзей
люлзей	людзей
лю-лзей	людзей
люлэей	людзей
пюдзей	людзей
≥юдз≥	людз≥
лю-дз≥	людз≥
людэ≥	людз≥
люлз≥	людз≥
людзь-м≥	людзьм≥
людэьм≥	людзьм≥
людэ€м	людз€м
лю-дз€х	людз€х
Ћюлм≥ла	Ћюдм≥ла
люд-на	людна
Ћ€во≥≥	Ћ€вон
л€вон≥-ха	л€вон≥ха
л€г-л≥	л€гл≥
л€с-на€	л€сна€
л€с-ных	л€сных
л€-цець	л€цець
ћабынь	ћабыць
мабынь	мабыць
млга	мага
магаэ≥н	магаз≥н
магаэ≥на	магаз≥на
магаэ≥нах	магаз≥нах
ма-газ≥не	магаз≥не
мага-з≥ны	магаз≥ны
маг≥-лЄҐскага	маг≥лЄҐскага
маг≥лЄҐ-шчыны	маг≥лЄҐшчыны
ма-г≥лу	маг≥лу
ма-г≥лы	маг≥лы
ма-г≥страл≥	маг≥страл≥
маг≥-страл≥	маг≥страл≥
маг≥ст-рал≥	маг≥страл≥
м€г≥страл≥	маг≥страл≥
маг-л≥	магл≥
м€гл≥	магл≥
магутнасн≥	магутнасц≥
ма-гутнасц≥	магутнасц≥
ма-гутнасць	магутнасць
магут-ным≥	магутным≥
магут-ных	магутных
м€гут-ных	магутных
маг-чыма	магчыма
магчымасней	магчымасцей
магчы-масцей	магчымасцей
магчымасн≥	магчымасц≥
маг-чымасц≥	магчымасц≥
магчымаснь	магчымасць
маг-чымасць	магчымасць
магчы-масць	магчымасць
маей	маЄй
мвЄй	маЄй
маЄ-рам	маЄрам
ћЋ«ы	ћј«ы
май-стра	майстра
май-строҐ	майстроҐ
мвйстроҐ	майстроҐ
млйстроҐ	майстроҐ
май-стры	майстры
майстзрства	майстэрства
майстэрстаа	майстэрства
май-стэрства	майстэрства
майстэр-ства	майстэрства
млйстэрства	майстэрства
ма-каЄнка	макаЄнка
малл	мала
малала€	малада€
маладзечанска-га	маладзечанскага
ма-ладога	маладога
мала-дога	маладога
маладо-га	маладога
малалога	маладога
маладон	маладой
малалой	маладой
мала-дому	маладому
ма-ладосць	маладосць
мала-ды	малады
малалы	малады
ма-лалы	малады
ма-ладым	маладым
мала-дым	маладым
ма-ладых	маладых
мала-дых	маладых
малалых	маладых
мвлвдых	маладых
млладых	маладых
мала-ды€	малады€
малалы€	малады€
ма-лака	малака
мала-ка	малака
малак€	малака
ма-лаком	малаком
маленстаа	маленства
ма-ленькай	маленькай
ма-ленька€	маленька€
малень-ка€	маленька€
малень-к≥м	маленьк≥м
малень-к≥х	маленьк≥х
ма-ленькую	маленькую
малень-кую	маленькую
ћалюнвк	малюнак
малюн-ках	малюнках
малюн-к≥	малюнк≥
мал€Ґн≥-чы€	мал€Ґн≥чы€
ман-гольскай	мангольскай
ма-неры	манеры
мансры	манеры
ма-рал≥	марал≥
ма-ральны€	маральны€
ма-раць	мараць
мар-кай	маркай
маркс≥змален≥н≥зма	маркс≥зма-лен≥н≥зма
маркс≥сцкален≥нскай	маркс≥сцка-лен≥нскай
мар-фа	марфа
марц≥но-в≥ч	марц≥нов≥ч
ма-ры	мары
ма-рыйскай	марыйскай
марык-са	марыкса
ма-рыл≥	марыл≥
Ћ\ары€	ћары€
ћарм€	ћары€
ма-ры€	мары€
маса-вых	масавых
ма-скве	маскве
маскв≥-чоҐ	маскв≥чоҐ
маск-ву	маскву
асквы	масквы
ма-сквы	масквы
маск-вы	масквы
мас-так	мастак
маствк	мастак
млстак	мастак
м€стак	мастак
ыастак	мастак
ма-стака	мастака
маста-ка	мастака
млстака	мастака
ма-стак≥	мастак≥
маствк≥	мастак≥
м€стак≥	мастак≥
ма-стакоҐ	мастакоҐ
маста-коҐ	мастакоҐ
маствкоҐ	мастакоҐ
мастлкоҐ	мастакоҐ
млстакоҐ	мастакоҐ
м€стакоҐ	мастакоҐ
мастакоҐграф≥каҐ	мастакоҐ-граф≥каҐ
ма-стаку	мастаку
мастанкага	мастацкага
ма-стацкага	мастацкага
мастанкае	мастацкае
мас-тацкае	мастацкае
маста≥≥кай	мастацкай
мастанкай	мастацкай
мастапкай	мастацкай
ма-стацкай	мастацкай
мас-тацкай	мастацкай
мастац-кай	мастацкай
мастацкан	мастацкай
мастацквй	мастацкай
мастацмай	мастацкай
мастацнай	мастацкай
мвствцквй	мастацкай
мастанка€	мастацка€
мастац-кал	мастацка€
ма-стацка€	мастацка€
мастац-ка€	мастацка€
мастанк≥	мастацк≥
мастац-к≥	мастацк≥
мастанк≥м	мастацк≥м
маствцк≥м	мастацк≥м
мастанк≥х	мастацк≥х
ма-стацк≥х	мастацк≥х
мастац-к≥х	мастацк≥х
маствцк≥х	мастацк≥х
млстацк≥х	мастацк≥х
мастанк≥€	мастацк≥€
ма-стацк≥€	мастацк≥€
мастац-к≥€	мастацк≥€
масгацтва	мастацтва
маста≥≥тва	мастацтва
мастантва	мастацтва
мас-тантва	мастацтва
мастаптва	мастацтва
мастацтаа	мастацтва
мастац-таа	мастацтва
ма-стацтва	мастацтва
мас-тацтва	мастацтва
мастац-тва	мастацтва
мастацт-ва	мастацтва
мастацтва*	мастацтва
мастацтвв	мастацтва
мастацтв€	мастацтва
мастацтпа	мастацтва
мастацт€а	мастацтва
маствцтва	мастацтва
маствцтвв	мастацтва
мастлцтва	мастацтва
мзстацтва	мастацтва
м€стацтва	мастацтва
мастантвам	мастацтвам
мастацтвг	мастацтве
мастац-тве	мастацтве
мастацтвс	мастацтве
мастацтпе	мастацтве
матэры€-лам	матэры€лам
ма-тэры€лаҐ	матэры€лаҐ
ма-тэры€ле	матэры€ле
ма-тэры€лу	матэры€лу
матзрь≥€-лы	матэры€лы
матэры€-лы	матэры€лы
мвтэры€лы	матэры€лы
матэры€ль-най	матэры€льнай
матэры€льнатэхн≥чнай	матэры€льна-тэхн≥чнай
матэ-ры€льную	матэры€льную
матэ-ры€льны€	матэры€льны€
матэры-€льны€	матэры€льны€
ма-ц≥	мац≥
млц≥	мац≥
ма-шын	машын
ма-шына	машына
ма-шынабудаванн€	машынабудаванн€
машы-ну	машыну
маю≥≥ь	маюць
маюнь	маюць
ма-юць	маюць
мвюць	маюць
мв€	ма€
ма€коҐска-га	ма€коҐскага
медалем	медалЄм
мсжам≥	межам≥
ме-жах	межах
мсжах	межах
ме-л≥	мел≥
мело-ды€	мелоды€
мера-прыемства	мерапрыемства
ме-рапрыемствы	мерапрыемствы
мерапрысмствы	мерапрыемствы
ме-рах	мерах
меркавань	меркаваць
мерка-ваць	меркаваць
ме-ры	меры
мсры	меры
месна	месца
меспа	месца
ме-сца	месца
мес-ца	месца
месцв	месца
месцл	месца
месц€	месца
мссца	месца
мес-цам	месцам
месцанара-джэнн€Ґ	месцанараджэнн€Ґ
мес-цах	месцах
мсс-цах	месцах
меспы	месцы
мес-цы	месцы
мс-с€ц	мес€ц
мес€ны	мес€цы
ме-с€цы	мес€цы
ме-тадам	метадам
мета-дам	метадам
мстадаҐ	метадаҐ
мета-лаҐ	металаҐ
мета-л≥ст	метал≥ст
метрл	метра
мстра	метра
мвтраҐ	метраҐ
метрлҐ	метраҐ
мстраҐ	метраҐ
мст-раҐ	метраҐ
ме-хан≥зацы≥	механ≥зацы≥
механ≥эмаҐ	механ≥змаҐ
Ћ\нннстерства	ћинистерства
ћмннстерства	ћинистерства
ћнннстврства	ћинистерства
ћнннстерсгва	ћинистерства
мнннстерства	министерства
ћнннстерствв	ћинистерства
ћнннстсрства	ћинистерства
м1	м≥
м≥жна-родным	м≥жнародным
м≥жна-родных	м≥жнародных
м≥-калай	м≥калай
м≥ка-лай	м≥калай
м≥-к≥та	м≥к≥та
м≥к≥-та	м≥к≥та
м≥-к≥ту	м≥к≥ту
ћ≥кол€	ћ≥кола
ћ≥копа	ћ≥кола
м≥ль-ЄнаҐ	м≥льЄнаҐ
м≥льЄ-наҐ	м≥льЄнаҐ
м≥ль-Єны	м≥льЄны
м≥льЄ-ны	м≥льЄны
м≥ль-€рды	м≥ль€рды
м≥-ма	м≥ма
м≥н≥ст-ра	м≥н≥стра
≥н≥ст-раҐ	м≥н≥страҐ
м≥н≥-страҐ	м≥н≥страҐ
м≥н≥ст-раҐ	м≥н≥страҐ
м≥н≥-стэрства	м≥н≥стэрства
м≥н≥с-тэрства	м≥н≥стэрства
м≥н≥стэр-ства	м≥н≥стэрства
ћ≥н≥стэрствв	ћ≥н≥стэрства
ћ≥н≥стэрствл	ћ≥н≥стэрства
Ћ\≥нск	ћ≥нск
ћ≥≥≥ск	ћ≥нск
ћ≥нек	ћ≥нск
мннск	м≥нск
л≥≥н-ска	м≥нска
м≥н-ска	м≥нска
ћ≥нск€	ћ≥нска
ћ≤нскага	ћ≥нскага
м≥н-скага	м≥нскага
ћ≥нскагв	ћ≥нскага
ћ≥нскан	ћ≥нскай
ћ≥нсквй	ћ≥нскай
ћ≥нск≤	ћ≥нск≥
м≥н-ску	м≥нску
м≥му-лага	м≥нулага
м≥-нулага	м≥нулага
м≥ну-лага	м≥нулага
м≥нулаг€	м≥нулага
м≥нулас	м≥нулае
м≥-нулым	м≥нулым
м≥ну-лым	м≥нулым
м≥пулым	м≥нулым
м≥-нут	м≥нут
м≥-нуту	м≥нуту
м≥-нуты	м≥нуты
м≥ну-ты	м≥нуты
м≥ран-коҐ	м≥ранкоҐ
м≥рна-га	м≥рнага
м≥р-нае	м≥рнае
м≥-ров≥ч	м≥ров≥ч
ћ≤ронавым	ћ≥ронавым
м≥-ру	м≥ру
ћ≤ха≤л	ћ≥ха≥л
м≥-ха≥л	м≥ха≥л
м≥хай-лав≥ч	м≥хайлав≥ч
м≥-хась	м≥хась
м≥цке-в≥ч	м≥цкев≥ч
м≥ц-кев≥ча	м≥цкев≥ча
ћ≥цксв≥ча	ћ≥цкев≥ча
мнс	мне
мно-га	многа
мног€	многа
мпога	многа
мно-гае	многае
многас	многае
многана-цы€нальнай	многанацы€нальнай
м≥≥ог≥х	мног≥х
мно-г≥х	мног≥х
Ћ≥ног≥€	мног≥€
мно-г≥€	мног≥€
мо-вах	мовах
моае	мове
мо-ве	мове
мовс	мове
моау	мову
мо-ву	мову
моаы	мовы
могунь	могуць
могупь	могуць
мо-гуць	могуць
мвдных	модных
мо-жа	можа
можв	можа
можл	можа
ћож€	ћожа
мож€	можа
мо-ж€	можа
мо-жна	можна
мож-на	можна
можнв	можна
можн€	можна
моладдэю	моладдзю
молалдзю	моладдзю
мола-дз≥	моладз≥
моладэ≥	моладз≥
молалз≥	моладз≥
молвдз≥	моладз≥
мо-ладзь	моладзь
моладэь	моладзь
молвдэь	моладзь
мо-лвдэь	моладзь
моллдзь	моладзь
момлнт	момант
моман-ту	моманту
манстра	монстра
мо-ра	мора
моц-на	моцна
моцн€	моцна
моцна-га	моцнага
моц-на€	моцна€
муж-насц≥	мужнасц≥
мужнаснь	мужнасць
муж-насць	мужнасць
музс≥	музе≥
муэе≥	музе≥
муэей	музей
муэею	музею
муэе€	музе€
му-зе€х	музе€х
музе-€х	музе€х
ћуэыка	ћузыка
муэыкантаҐ	музыкантаҐ
музмк≥	музык≥
му-зык≥	музык≥
муэык≥	музык≥
муэы-к≥	музык≥
муэыку	музыку
музыны	музыцы
му-зыцы	музыцы
муэыцы	музыцы
музыч-нага	музычнага
муэычнага	музычнага
му-зычнай	музычнай
муэычнай	музычнай
му-эычнай	музычнай
му-зычную	музычную
муэычную	музычную
му-зычны	музычны
муэычны	музычны
муэычным	музычным
муэычным≥	музычным≥
муэычных	музычных
муэыч-ных	музычных
му-зычны€	музычны€
муэычны€	музычны€
му-раваны	мураваны
ћус≥нь	ћус≥ць
мус≥нь	мус≥ць
му-с≥ць	мус≥ць
м€-жу	м€жу
м€к-ка	м€кка
мннс	м€не
м€-не	м€не
м€нс	м€не
м€-нс	м€не
м€-са	м€са
м€с-ц≥ны	м€сц≥ны
м€сцо-вай	м€сцовай
на-адварот	наадварот
наадва-рот	наадварот
на-быҐ	набыҐ
навагруд-скага	навагрудскага
навагрудчы-не	навагрудчыне
наваколь-нага	навакольнага
нава-рыча	наварыча
нааат	нават
наваг	нават
на-ват	нават
навзт	нават
нав€т	нават
на€ат	нават
нлват	нават
навсдваюць	наведваюць
нааук	навук
на-вук	навук
нлвук	навук
нааук≥	навук≥
на-вук≥	навук≥
наву-к≥	навук≥
нввук≥	навук≥
нлвук≥	навук≥
навуповатзхн≥чна€	навукова-тэхн≥чна€
навуковатэхн≥чны	навукова-тэхн≥чны
на-вуковы€	навуковы€
на-вуку	навуку
на-вум	навум
на-вумов≥ч	навумов≥ч
нааучальных	навучальных
наву-чалы≥ых	навучальных
на-вучальных	навучальных
наву-чальных	навучальных
навучан-н€	навучанн€
нагл€д-ную	нагл€дную
н€д	над
над-звычай	надзвычай
надзвы-чай	надзвычай
надзвычан	надзвычай
н€дзвычай	надзвычай
надзЄн-ны	надзЄнны
на-дзею	надзею
на-дэею	надзею
на-друкаваны	надрукаваны
надрука-ваны	надрукаваны
на-зад	назад
назал	назад
наэад	назад
назаҐсЄ-ды	назаҐсЄды
на-эаҐсЄды	назаҐсЄды
наз-вай	назвай
наэваҐ	назваҐ
названь	назваць
назы-вае	называе
называс	называе
называе≥ша	называецца
найболын	найбольш
найболып	найбольш
най-больш	найбольш
н€йбольш	найбольш
найв€л≥к-шай	найв€л≥кшай
найв€л≥к-ша€	найв€л≥кша€
найв€л≥к-шых	найв€л≥кшых
найшы-рэйшы€	найшырэйшы€
нак≥рлваны	нак≥раваны
нак≥роҐ-ваюцца	нак≥роҐваюцца
нак≥роҐва-юць	нак≥роҐваюць
на-ладз≥ла	наладз≥ла
наладз≥нь	наладз≥ць
налгаса	налгала
належань	належаць
належынь	належыць
на-лежыць	належыць
нале-жыць	належыць
нвм	нам
нама-галас€	намагалас€
на-месн≥к	намесн≥к
намссн≥к	намесн≥к
наме-чаны	намечаны
на-м≥	нам≥
нлм≥	нам≥
на-перад	наперад
напсрад	наперад
нап≥-сал≥	нап≥сал≥
на-п≥санн≥	нап≥санн≥
нап≥сан-н€	нап≥санн€
нап≥-саны	нап≥саны
нап≥са-ны€	нап≥саны€
на-п≥саць	нап≥саць
нап≥-саць	нап≥саць
на-прамку	напрамку
напружа-най	напружанай
на-прыклад	напрыклад
напры-клад	напрыклад
напрык-лад	напрыклад
напрыклал	напрыклад
н€прыклад	напрыклад
напэҐ-на	напэҐна
нап€рэ-дадн≥	нап€рэдадн≥
нараджаец-ца	нараджаецца
на-ралжалас€	нараджалас€
нараджал≥-с€	нараджал≥с€
нараджзнн€	нараджэнн€
нара-джзнн€	нараджэнн€
нара-джэ≥≥н€	нараджэнн€
на-раджэнн€	нараджэнн€
нара-джэнн€	нараджэнн€
нараджэн-н€	нараджэнн€
на-радзе	нарадзе
на-радз≥лас€	нарадз≥лас€
нарадз≥-лас€	нарадз≥лас€
на-радз≥Ґс€	нарадз≥Ґс€
наралу	нараду
наралы	нарады
на-род	народ
нарол	народ
нврод	народ
на-рода	народа
наро-да	народа
народл	народа
нарола	народа
на-рола	народа
наро-ла	народа
нарпда	народа
нвродв	народа
нв-родв	народа
нвро-дв	народа
на-родам	народам
наро-дам	народам
наролам	народам
нвродвм	народам
на-родам≥	народам≥
на-родаҐ	народаҐ
наро-даҐ	народаҐ
наролаҐ	народаҐ
нвродаҐ	народаҐ
пародаҐ	народаҐ
на-родзе	народзе
народзс	народзе
на-роднага	народнага
народна-га	народнага
народнагз	народнага
народнагл	народнага
народнвга	народнага
народпага	народнага
наролнага	народнага
на-роднай	народнай
народ-най	народнай
народнан	народнай
Ќароднан	Ќароднай
народнвй	народнай
народнлй	народнай
наролнай	народнай
наролна€	народна€
народ-ную	народную
на-родны	народны
народ-ны	народны
наролны	народны
нлродны	народны
наролным	народным
на-родных	народных
наролных	народных
нлродных	народных
на-родны€	народны€
народ-ны€	народны€
наролны€	народны€
на-роды	народы
наро-ды	народы
на-рыс	нарыс
нврыс	нарыс
нв-рыс	нарыс
нары-саҐ	нарысаҐ
нарь≥-саҐ	нарысаҐ
на-рысе	нарысе
нарых-тоҐках	нарыхтоҐках
на-рэшце	нарэшце
нарэш-це	нарэшце
нарэшцс	нарэшце
нвс	нас
насе-в≥ч	насев≥ч
населы≥≥цтва	насельн≥цтва
насельн≥цтаа	насельн≥цтва
на-сельн≥цтва	насельн≥цтва
насельн≥ц-тва	насельн≥цтва
нассльн≥цтва	насельн≥цтва
на-стаҐн≥к	настаҐн≥к
настаҐ-н≥ка	настаҐн≥ка
на-стаҐн≥кам≥	настаҐн≥кам≥
на-стаҐн≥каҐ	настаҐн≥каҐ
настаҐ-н≥каҐ	настаҐн≥каҐ
настаҐн≥-каҐ	настаҐн≥каҐ
на-стаҐн≥к≥	настаҐн≥к≥
настаҐ-н≥к≥	настаҐн≥к≥
на-стойл≥ва	настойл≥ва
настой-л≥ва	настойл≥ва
наступ≥-ла	наступ≥ла
на-ступ≥ць	наступ≥ць
наступ-нага	наступнага
на-ступны	наступны
нас-тупным	наступным
насупрань	насупраць
на-супраць	насупраць
на-сустрач	насустрач
нвсустрач	насустрач
на-татак	нататак
на-таша	наташа
ната-ша	наташа
натх-нЄнай	натхнЄнай
нат-хн≥ла	натхн≥ла
на-тхн€е	натхн€е
натх-н€е	натхн€е
наҐ-рад	наҐрад
наҐрал	наҐрад
на-ц≥ску	нац≥ску
на-цый	нацый
нацы€на-л≥стаҐ	нацы€нал≥стаҐ
наны€нальнага	нацы€нальнага
нацы€-нальнага	нацы€нальнага
нацы€наль-нага	нацы€нальнага
нацы€налы≥ай	нацы€нальнай
на-цы€нальнай	нацы€нальнай
нацы€наль-най	нацы€нальнай
нацы€-нальнасцей	нацы€нальнасцей
нацы€наль-ную	нацы€нальную
на-цы€нальным	нацы€нальным
нацы€наль-ных	нацы€нальных
нацы€-налы≥ы€	нацы€нальны€
нацюр-мортаҐ	нацюрмортаҐ
на-чальн≥к	начальн≥к
на-ша	наша
нашв	наша
нвшв	наша
н€ша	наша
н€-ша	наша
на-шага	нашага
наша-га	нашага
нашагв	нашага
наш€га	нашага
нвшага	нашага
нзшага	нашага
пашага	нашага
нан≥ай	нашай
наша≥≥	нашай
на-шай	нашай
нашан	нашай
нашвй	нашай
нашзй	нашай
нашлй	нашай
наш€й	нашай
нвшай	нашай
нвшвй	нашай
нзшай	нашай
нлшай	нашай
н€шай	нашай
н€-шай	нашай
на-шу	нашу
на-шчадкаҐ	нашчадкаҐ
нашм	нашы
нашн	нашы
на-шы	нашы
нвшы	нашы
нлшы	нашы
н€шы	нашы
на-шым	нашым
н€шым	нашым
н€-шым	нашым
на-шым≥	нашым≥
на-шых	нашых
нвшых	нашых
на-шэсце	нашэсце
≥≥е	не
Ќс	Ќе
нс	не
не-абходна	неабходна
нсабходна	неабходна
неабход-нае	неабходнае
неаб-ходную	неабходную
неабход-ным	неабходным
неад-наразова	неаднаразова
неадоль-ную	неадольную
не-ба	неба
нсба	неба
нс-ба	неба
небс	небе
неве-рагодна	неверагодна
невера-годна	неверагодна
нсв€дома	нев€дома
нев€до-мых	нев€домых
нсв€л≥к≥	нев€л≥к≥
нсв€л≥к≥€	нев€л≥к≥€
нсда-лЄка	недалЄка
не-далЄк≥м	недалЄк≥м
неластаткова	недастаткова
нелахоп	недахоп
не-дахопаҐ	недахопаҐ
недахоны	недахопы
незабыҐ-ны€	незабыҐны€
незалеж-на	незалежна
неза-лежнасц≥	незалежнасц≥
не-залежнасць	незалежнасць
неза-лежнасць	незалежнасць
незаслу-жана	незаслужана
незвычай-на€	незвычайна€
незвычай-ную	незвычайную
неэвычайную	незвычайную
не-звычайны	незвычайны
незра-зумелы€	незразумелы€
ней-ка€	нейка€
ней-к≥	нейк≥
ненкую	нейкую
нейтра-л≥тэту	нейтрал≥тэту
нейтраль-на€	нейтральна€
не-кал≥	некал≥
не-кальк≥	некальк≥
некаль-к≥	некальк≥
не-квльк≥	некальк≥
неклльк≥	некальк≥
нек€льк≥	некальк≥
нскальк≥	некальк≥
некаль-к≥х	некальк≥х
не-каму	некаму
некато-ры	некаторы
не-каторых	некаторых
некато-рых	некаторых
нематорых	некаторых
нскаторых	некаторых
некато-ры€	некаторы€
нскаторы€	некаторы€
нс-каторы€	некаторы€
нскато-ры€	некаторы€
нелыа	нельга
нель-га	нельга
Ќсльга	нельга
нсльга	нельга
не-магчыма	немагчыма
немаг-чыма	немагчыма
нсмагчыма	немагчыма
немны	немцы
непа-рушнае	непарушнае
непа-рушна€	непарушна€
нспасрэдна	непасрэдна
нспасрэдных	непасрэдных
непаҐ-торна€	непаҐторна€
неҐзабавс	неҐзабаве
не-шта	нешта
нс€к	не€к
Ќс€к	Ќе€к
н≥бм	н≥бы
н≥-быта	н≥быта
н≥ка-вых	н≥кавых
н≥к≥фа-раҐ	н≥к≥фараҐ
≥≥≥кол≥	н≥кол≥
н≥-кол≥	н≥кол≥
н≥-кольк≥	н≥кольк≥
≥≥≥х-то	н≥хто
н≥-чога	н≥чога
н≥чо-га	н≥чога
н≥-€к≥х	н≥€к≥х
новабу-доҐл€Ґ	новабудоҐл€Ґ
ноаага	новага
но-вага	новага
нова-га	новага
новагв	новага
новаг€	новага
новвгв	новага
нов€га	новага
нонага	новага
нопага	новага
но-вае	новае
новас	новае
но-вай	новай
нован	новай
новвй	новай
нопа€	нова€
но-в≥кава	нов≥кава
ноаую	новую
но-вую	новую
но-вы	новы
новы-м≥	новым≥
нопым≥	новым≥
ноаых	новых
но-вых	новых
ноаы€	новы€
но-вы€	новы€
нопы€	новы€
но€ы€	новы€
нос≥нь	нос≥ць
нос€нь	нос€ць
нумвры	нумары
н€-гледз€чы	н€гледз€чы
н€-даҐна	н€даҐна
н€даҐ-на	н€даҐна
н€даҐ-н€	н€даҐна
Ќ€длҐна	Ќ€даҐна
н€лаҐна	н€даҐна
н€дзвл€х	н€дзел€х
н€дзсл€х	н€дзел€х
н€дэел€х	н€дзел€х
н€-лЄгка	н€лЄгка
н€-ма	н€ма
н€мв	н€ма
н€мз	н€ма
н€мл	н€ма
н€м€	н€ма
н€ма-ла	н€мала
н€м€ла	н€мала
н€мецкафашысцк≥м≥	н€мецка-фашысцк≥м≥
н€мецкафашысцк≥х	н€мецка-фашысцк≥х
н€-мецк≥€	н€мецк≥€
Ќ€м≥г€	Ќ€м≥га
н€-м≥г≥	н€м≥г≥
н€-рэдка	н€рэдка
н€рэд-ка	н€рэдка
Ќнсв≥жскага	Ќ€св≥жскага
н€спын-нага	н€спыннага
н€-спынных	н€спынных
н€ста-чы	н€стачы
н€-Ґх≥льна	н€Ґх≥льна
н€-хай	н€хай
Ќ€хвй	Ќ€хай
опер-ны	оперны
опер-ных	оперных
оперы*	оперы
опсры	оперы
оргвн	орган
ордзна	ордэна
пабл≥эу	пабл≥зу
пабу-давал≥	пабудавал≥
па-будавана	пабудавана
пабудаааны	пабудаваны
пабу-даваны	пабудаваны
пабу-лаваных	пабудаваных
пвбудвваҐ	пабудаваҐ
пабы-вала	пабывала
пабы-вал≥	пабывал≥
па-бываҐ	пабываҐ
пабызаҐ	пабываҐ
па-быҐ	пабыҐ
па-вагай	павагай
паважа-ны€	паважаны€
паведа-м≥л≥	паведам≥л≥
паведа-м≥Ґ	паведам≥Ґ
павсдам≥Ґ	паведам≥Ґ
па-ведамленне	паведамленне
паве-дамленне	паведамленне
паведам-л€е	паведамл€е
па-вел	павел
пав≥льЄ-ны	пав≥льЄны
≥≥ав≥нен	пав≥нен
пав≥-нен	пав≥нен
плв≥нен	пав≥нен
паа≥нна	пав≥нна
пав≥н-на	пав≥нна
пап≥нна	пав≥нна
пав≥н-ны	пав≥нны
пап≥нны	пав≥нны
пвв≥нны	пав≥нны
плв≥нны	пав≥нны
п€в≥нны	пав≥нны
п€в≥н-ны	пав≥нны
паводз≥-нам≥	паводз≥нам≥
паволы≥а	павольна
па-выс≥ць	павыс≥ць
павышэн-н≥	павышэнн≥
па-в€л≥чылас€	пав€л≥чылас€
пав€л≥чы-л≥с€	пав€л≥чыл≥с€
пав€л≥-чыць	пав€л≥чыць
пагл€дзень	пагл€дзець
па-гл€дзець	пагл€дзець
пагл€-дз≥	пагл€дз≥
на-грозы	пагрозы
па-грозы	пагрозы
па-гутарыць	пагутарыць
пвд	пад
пзд	пад
пададзе-ны	пададзены
падар-ваць	падарваць
падарож-жа	падарожжа
паларожжа	падарожжа
падарож-жаҐ	падарожжаҐ
па-дарожжах	падарожжах
пада-рожжах	падарожжах
пада-рунак	падарунак
паларунк≥	падарунк≥
пада-рыць	падарыць
на-даць	падаць
пад-бегла	падбегла
пад-в€ргаҐс€	падв€ргаҐс€
падзс≥	падзе≥
па-дзей	падзей
п€дзей	падзей
падз€ка-ваць	падз€каваць
падз€-ку	падз€ку
пад-копы	падкопы
падкрэсл≥вас	падкрэсл≥вае
пад-крэсл≥ваҐ	падкрэсл≥ваҐ
падкрэс-л≥Ґ	падкрэсл≥Ґ
пвдкрэсл≥Ґ	падкрэсл≥Ґ
палн€Ґс€	падн€Ґс€
палобны	падобны
палобны€	падобны€
падп≥с-ных	падп≥сных
падраб€эна	падраб€зна
пад-раб€зным	падраб€зным
падрых-таваны	падрыхтаваны
падрыхтананы	падрыхтаваны
падрых-таваць	падрыхтаваць
пад-рыхтоҐцы	падрыхтоҐцы
падрыхтоҐ-цы	падрыхтоҐцы
палрыхтоҐцы	падрыхтоҐцы
палставы	падставы
паду-май	падумай
падумань	падумаць
паду-маць	падумаць
палумаць	падумаць
паеэдка	паездка
паезлк≥	паездк≥
па-ехаць	паехаць
пажаланн≥	пажаданн≥
паза-штатны	пазаштатны
паз≥ны≥	паз≥цы≥
па-з≥цы≥	паз≥цы≥
паэ≥цый	паз≥цый
па-з≥цы€х	паз≥цы€х
пазнаЄ-м≥л≥с€	пазнаЄм≥л≥с€
па-энаЄм≥л≥с€	пазнаЄм≥л≥с€
паэнаЄм≥Ґс€	пазнаЄм≥Ґс€
пазнаЄ-м≥цца	пазнаЄм≥цца
паэнаЄм≥цца	пазнаЄм≥цца
√≤азней	пазней
па-зней	пазней
пайсн≥	пайсц≥
пай-сц≥	пайсц≥
пай-шла	пайшла
паншла	пайшла
пай-шоҐ	пайшоҐ
па-казана	паказана
пака-заҐ	паказаҐ
паказань	паказаць
па-казаць	паказаць
пакаэаць	паказаць
паказвас	паказвае
па-казвас	паказвае
па-казваецца	паказваецца
паказвань	паказваць
па-казу	паказу
пака-ленн≥	пакаленн≥
пакален-н≥	пакаленн≥
па-каленн€	пакаленн€
пакален-н€	пакаленн€
пакамун≥стычнаму	па-камун≥стычнаму
па-карыцел€	пакарыцел€
пакарыце-л€м	пакарыцел€м
пакарэн-н€	пакарэнн€
пак≥-дал≥	пак≥дал≥
пак≥-нуҐ	пак≥нуҐ
пак≥нунь	пак≥нуць
па-к≥нуць	пак≥нуць
пак≥-нуць	пак≥нуць
па-клЄп	паклЄп
нако≥	пако≥
па-кой	пакой
па-кончыць	пакончыць
пакон-чыць	пакончыць
па-куль	пакуль
п€куль	пакуль
пала-цам	палацам
па-лепшыць	палепшыць
палеп-шыць	палепшыць
па-лет	палет
палет	палЄт
па-лЄт	палЄт
пвлЄт	палЄт
па-лЄтах	палЄтах
палЄ-тах	палЄтах
палбту	палЄту
палету	палЄту
па-лЄту	палЄту
палЄ-ту	палЄту
палеҐ	палЄҐ
палеце	палЄце
пал≥граф≥ч-ным	пал≥граф≥чным
пал≥ты-ка	пал≥тыка
па-л≥тык≥	пал≥тык≥
пал≥-тык≥	пал≥тык≥
пал≥тыч-най	пал≥тычнай
пал≥тыч-ную	пал≥тычную
пал≥тыч-ны	пал≥тычны
пвл≥тычны€	пал≥тычны€
пал≥-цыю	пал≥цыю
палот-н≥шчах	палотн≥шчах
па-лотны	палотны
палым€-нага	палым€нага
пальчэҐ-скага	пальчэҐскага
па-люб≥ць	палюб≥ць
пал€-цела	пал€цела
пал€-цеҐ	пал€цеҐ
па-мешчыка	памешчыка
па-м≥ж	пам≥ж
памы-лак	памылак
пам€-тае	пам€тае
па-м€таю	пам€таю
пам€нь	пам€ць
пвм€ць	пам€ць
пам€шканнс	пам€шканне
па-нерыҐ	панерыҐ
пан€ц-ц≥	пан€цц≥
ѕапершае	ѕа-першае
папсры	паперы
папоҐ-н≥Ґс€	папоҐн≥Ґс€
па-прас≥Ґ	папрас≥Ґ
≤≤апул€рнасць	папул€рнасць
ла-рад	парад
паралак	парадак
парад-ку	парадку
паралку	парадку
пара-ды	парады
паране-ны	паранены
парансны	паранены
параҐ-нанн≥	параҐнанн≥
параҐнан-н≥	параҐнанн≥
пара-шутыстаҐ	парашутыстаҐ
парка-вую	паркавую
пар-най	парнай
партрзты	партрэты
парт-рэты	партрэты
партрэ-ты	партрэты
партыэан	партызан
партызан-скага	партызанскага
пар-тызанскай	партызанскай
партызан-скай	партызанскай
нартызаны	партызаны
партыэаны	партызаны
ларты≥	парты≥
нарты≥	парты≥
паргы≥	парты≥
пар-ты≥	парты≥
пврты≥	парты≥
пзрты≥	парты≥
плрты≥	парты≥
партыйнаарган≥зацыйнай	партыйна-арган≥зацыйнай
партыннага	партыйнага
пар-тыйнай	партыйнай
партый-най	партыйнай
пар-тыйна€	партыйна€
партый-на€	партыйна€
партый-ных	партыйных
пар-ты€	парты€
пврты€	парты€
пвр-ты€	парты€
пасадз≥нь	пасадз≥ць
па-сЄлка	пасЄлка
пасЄл-ках	пасЄлках
па-сЄлку	пасЄлку
пасла-л≥	паслал≥
па-слаць	паслаць
паслухай-це	паслухайце
г≥асл€	пасл€
ласл€	пасл€
насл€	пасл€
па-сл€	пасл€
пас-л€	пасл€
ѕвсл€	пасл€
пзсл€	пасл€
плсл€	пасл€
ѕ€сл€	ѕасл€
п€сл€	пасл€
пасл€-ваенны€	пасл€ваенны€
ласп€хова	пасп€хова
пас-п€хова	пасп€хова
пасп€хо-ва	пасп€хова
пас-п€ховага	пасп€ховага
пасп€хо-вага	пасп€ховага
пастав≥-л≥	пастав≥л≥
пастав≥пь	пастав≥ць
паста-в≥ць	пастав≥ць
паста-≥м	паста≥м
пастаноҐ-шчык	пастаноҐшчык
па-стаҐлены	пастаҐлены
пасту-паюць	паступаюць
паступ≥нь	паступ≥ць
пасту-п≥ць	паступ≥ць
пас€-джэнне	пас€джэнне
пас€лжэнн≥	пас€джэнн≥
пас€-джэнн€	пас€джэнн€
патраба-вальнасць	патрабавальнасць
патраба-ванн≥	патрабаванн≥
патраба-ванн€м	патрабаванн€м
пат-рабаваць	патрабаваць
натрабуе	патрабуе
па-трабуе	патрабуе
патра-буе	патрабуе
патрабус	патрабуе
патры€-тычна€	патры€тычна€
патрэ-бен	патрэбен
па-трзбна	патрэбна
патрэб-на	патрэбна
па-трэбны	патрэбны
натрэбы	патрэбы
паты-л≥ха	патыл≥ха
паҐ-дз≥кай	паҐдз≥кай
паҐ-натой	паҐнатой
паҐ-тараць	паҐтараць
паход-жанн€	паходжанн€
пача-ла	пачала
па-чалас€	пачалас€
пача-так	пачатак
пачат-ку	пачатку
па-чаҐ	пачаҐ
па-чаць	пачаць
пачнем	пачнЄм
па-чуҐ	пачуҐ
па-чу≥шЄ	пачуццЄ
па-чуццЄ	пачуццЄ
пачуццсм	пачуццем
пачуц-ц€Ґ	пачуцц€Ґ
пачуш≥€Ґ	пачуцц€Ґ
па-чын	пачын
пачынас	пачынае
пачы-наецца	пачынаецца
пачынаец-ца	пачынаецца
пачынасцца	пачынаецца
пачынаюнь	пачынаюць
па-чынаючы	пачынаючы
пачы-наючы	пачынаючы
пачынаю-чы	пачынаючы
пачынаю-чых	пачынаючых
па-чэснай	пачэснай
пашто-вак	паштовак
па-шырыҐс€	пашырыҐс€
па-шырыць	пашырыць
паэ-з≥≥	паэз≥≥
паээ≥≥	паэз≥≥
паэ-ма	паэма
пазмы	паэмы
наэт	паэт
пазт	паэт
ѕлэт	ѕаэт
п€эт	паэт
паэтл	паэта
па-этаҐ	паэтаҐ
паэ-таҐ	паэтаҐ
паэ-ты	паэты
плэты	паэты
паэ-тычных	паэтычных
па€-дынак	па€дынак
педа-гаг≥чнай	педагаг≥чнай
пелагог	педагог
пенс≥€-нер	пенс≥€нер
пе-раваг≥	пераваг≥
пера-грузак	перагрузак
пе-рад	перад
перал	перад
первд	перад
пер€д	перад
псрад	перад
перада-вал≥	перадавал≥
пера-дав≥кам	перадав≥кам
перадав≥ка-м≥	перадав≥кам≥
перадаа≥-коҐ	перадав≥коҐ
пе-радав≥коҐ	перадав≥коҐ
перада-в≥коҐ	перадав≥коҐ
перада-вога	перадавога
первдввогв	перадавога
перв-дввогв	перадавога
первдв-вогв	перадавога
псрадавы	перадавы
пералавым	перадавым
пера-давых	перадавых
пералавых	перадавых
псрадавых	перадавых
пе-радавы€	перадавы€
пера-давы€	перадавы€
пе-радае	перадае
псрадаҐ	перадаҐ
перадань	перадаць
пе-радань	перадаць
пе-радаць	перадаць
пера-даць	перадаць
псрадаць	перадаць
пс-радача	перадача
пераехау	пераехаҐ
пе-раканальна	пераканальна
псраканальна	пераканальна
пера-канаҐча	пераканаҐча
ѕсраклад	ѕераклад
пералес-к≥	пералеск≥
нерамог	перамог
псрамог	перамог
пе-рамога	перамога
пера-мога	перамога
перамо-га	перамога
ѕсрамога	ѕерамога
перамо-гай	перамогай
лерлмог≥	перамог≥
пе-рамог≥	перамог≥
перамо-г≥	перамог≥
пера-могу	перамогу
пе-рамогуць	перамогуць
псра-можцы	пераможцы
нерамозе	перамозе
пера-нЄс	перанЄс
перапоҐ-нены	перапоҐнены
перапын≥-ла	перапын≥ла
пе-рапынку	перапынку
ператва-рыць	ператварыць
пера-тварэнн€	ператварэнн€
пераҐзы-дзе	пераҐзыдзе
пе-раҐтварэнн≥	пераҐтварэнн≥
пераходз≥нь	пераходз≥ць
псраходз≥ць	пераходз≥ць
пе-рашкаджае	перашкаджае
пера-шкаджае	перашкаджае
пера-шкаджаюць	перашкаджаюць
псрсанажаҐ	персанажаҐ
перспек-тыву	перспектыву
перспек-тывы	перспектывы
псрспектывы	перспектывы
псрш	перш
пер-шага	першага
перша-га	першага
першвгв	першага
псршага	першага
пер-шай	першай
першвй	першай
псршай	першай
пер-шама€	першама€
ѕершамв€	ѕершама€
пер-шаму	першаму
пер-шачарговы€	першачарговы€
пер-ша€	перша€
пер-шую	першую
псршую	першую
лершы	першы
пер-шы	першы
псршы	першы
лершым	першым
пер-шым	першым
псршым	першым
першы-м≥	першым≥
псршым≥	першым≥
псршых	першых
лершы€	першы€
нершы€	першы€
пер-шы€	першы€
псршы€	першы€
перы-€д	перы€д
псры€д	перы€д
перы€лу	перы€ду
псры€ду	перы€ду
п'сса	п'еса
н'есам	п'есам
п'е-се	п'есе
п'есс	п'есе
п'ссе	п'есе
песнн	песен
лесень	песень
пе-сень	песень
песснь	песень
песм≥	песн≥
пес-м≥	песн≥
пес-н≥	песн≥
пссн≥	песн≥
пвсню	песню
пес-ню	песню
лесн€	песн€
пес-н€	песн€
пссн€	песн€
песннх	песн€х
пес-н€х	песн€х
п'ссу	п'есу
м'есы	п'есы
н'есы	п'есы
п'ссы	п'есы
псць	пець
ѕннскнх	ѕинских
пнсателей	писателей
п≥л≥па-в≥ч	п≥л≥пав≥ч
п≥лотамкасманаҐтам	п≥лотам-касманаҐтам
п≥лоткасманаҐт	п≥лот-касманаҐт
п≥-лоту	п≥лоту
п≥н-скага	п≥нскага
п≥н-чанам	п≥нчанам
п≥сала-с€	п≥салас€
п≥-сал≥	п≥сал≥
п≥-саҐ	п≥саҐ
п≥сань	п≥саць
п≥-саць	п≥саць
п≥сь-ме	п≥сьме
л≥сьменн≥к	п≥сьменн≥к
н≥сьменн≥к	п≥сьменн≥к
п≥сь-менн≥к	п≥сьменн≥к
п≥сь-мснн≥к	п≥сьменн≥к
п≥сь-менн≥ка	п≥сьменн≥ка
п≥сьменн≥-ка	п≥сьменн≥ка
п≥сьменн≥кв	п≥сьменн≥ка
п≥сьменн≥кл	п≥сьменн≥ка
п≥сьменп≥ка	п≥сьменн≥ка
п≥сьмепн≥ка	п≥сьменн≥ка
п≥сьмснн≥ка	п≥сьменн≥ка
п≥сьменн≥квм≥	п≥сьменн≥кам≥
л≥сьменн≥каҐ	п≥сьменн≥каҐ
п≥гьменн≥каҐ	п≥сьменн≥каҐ
п≥сьменн≥кау	п≥сьменн≥каҐ
п≥сь-менн≥каҐ	п≥сьменн≥каҐ
п≥сьменн≥-каҐ	п≥сьменн≥каҐ
п≥сьменн≥клҐ	п≥сьменн≥каҐ
п≥сьмснн≥каҐ	п≥сьменн≥каҐ
п≥сьмсн-н≥каҐ	п≥сьменн≥каҐ
п≥сьмсш≥≥каҐ	п≥сьменн≥каҐ
п≥сь-менн≥ку	п≥сьменн≥ку
п≥сьменн≥ны	п≥сьменн≥цы
н≥сьмо	п≥сьмо
л≥сьмы	п≥сьмы
п≥сь-мы	п≥сьмы
п≥ш€	п≥ша
п≥шунь	п≥шуць
п≥-шуць	п≥шуць
≥≥≥шы	п≥шы
п≥€не-ра	п≥€нера
п≥€не-ры	п≥€неры
пладано-с≥ць	пладанос≥ць
нлан	план
пллн	план
нлана	плана
пла-на	плана
пла-нам≥	планам≥
пла-не	плане
пла-нета	планета
пла-неты	планеты
плане-ты	планеты
пла-неце	планеце
пла-ны	планы
пле-нума	пленума
плену-ма	пленума
пло-шча	плошча
пло-шчаҐ	плошчаҐ
пло-шчах	плошчах
ллошчы	плошчы
пло-шчы	плошчы
пл€-чыма	пл€чыма
пл€чы-ма	пл€чыма
побвч	побач
по-дзв≥г	подзв≥г
подэв≥г	подзв≥г
подэ-в≥г	подзв≥г
ползв≥г	подзв≥г
подзн≥гам	подзв≥гам
по-дэв≥г≥	подзв≥г≥
по-дзв≥гу	подзв≥гу
подэв≥-гу	подзв≥гу
по-дых	подых
ѕоланкага	ѕолацкага
полацка-га	полацкага
полз-в≥гаҐ	ползв≥гаҐ
полы-м€	полым€
поль-скай	польскай
поль-шчы	польшчы
пом-н≥к	помн≥к
пом-н≥ка	помн≥ка
пом-н≥каҐ	помн≥каҐ
пом-н≥ках	помн≥ках
помн≥ш≥а	помн≥цца
по-спех	поспех
по-спсх	поспех
по-спехам	поспехам
поспе-хам	поспехам
поспехлм	поспехам
поспехвҐ	поспехаҐ
поспсхаҐ	поспехаҐ
пос-псхаҐ	поспехаҐ
лоспехах	поспехах
по-спехах	поспехах
поспе-хах	поспехах
по-спех≥	поспех≥
поспе-х≥	поспех≥
поспс-х≥	поспех≥
по-спеху	поспеху
поспе-ху	поспеху
поспсху	поспеху
по-ступ	поступ
по-тым	потым
поҐ-на	поҐна
поҐ-нага	поҐнага
поҐна-га	поҐнага
поҐ-нае	поҐнае
поҐ-най	поҐнай
поҐнасню	поҐнасцю
поҐ-насцю	поҐнасцю
поҐ-нач	поҐнач
поҐ-ным	поҐным
пошу-каҐ	пошукаҐ
по-шук≥	пошук≥
прл	пра
пр€	пра
прабле-ма	праблема
праблсма	праблема
праблсмах	праблемах
праб-лемы	праблемы
прабле-мы	праблемы
праблсмы	праблемы
праб-лсмы	праблемы
пра-ва	права
пра-вадыра	правадыра
правалыра	правадыра
пра-ведзен	праведзен
правесн≥	правесц≥
пра-вЄҐ	правЄҐ
пра-в≥ла	прав≥ла
прав≥ль-на	прав≥льна
прав≥ль-най	прав≥льнай
пра-в≥льны	прав≥льны
прав≥ль-ны	прав≥льны
право-дз≥цца	праводз≥цца
праводз≥ш≥а	праводз≥цца
праводз≥пь	праводз≥ць
пра-водз≥ць	праводз≥ць
право-дз€цца	праводз€цца
праграмл	праграма
ѕраграмс	ѕраграме
праграмс	праграме
пра-граму	праграму
прагра-му	праграму
прагрлму	праграму
ѕраграчы	ѕраграмы
ѕрагрвмы	ѕраграмы
пра-грэс	прагрэс
прагрэс≥Ґ-нае	прагрэс≥Ґнае
прагрэс≥Ґ-ным	прагрэс≥Ґным
пра-грэсу	прагрэсу
прад-метаҐ	прадметаҐ
прадме-таҐ	прадметаҐ
праднрыемства	прадпрыемства
прадпрыемстаа	прадпрыемства
прад-прыемства	прадпрыемства
праднрыемстваҐ	прадпрыемстваҐ
пралпрыемстваҐ	прадпрыемстваҐ
прад-прыемствы	прадпрыемствы
пралпрыемствы	прадпрыемствы
прад-стаҐлена	прадстаҐлена
прадстаҐлены€	прадстаҐленн€
прадстаҐ-лены	прадстаҐлены
прадстаҐ-леных	прадстаҐленых
прад-стаҐн≥коҐ	прадстаҐн≥коҐ
пралстаҐн≥коҐ	прадстаҐн≥коҐ
пра-дуктаҐ	прадуктаҐ
пра-дукты	прадукты
прадукны≥	прадукцы≥
прадук-ны≥	прадукцы≥
пра-дукцы≥	прадукцы≥
прадук-цы≥	прадукцы≥
прадукцыйнас-ц≥	прадукцыйнасц≥
прадукцый-насць	прадукцыйнасць
прадук-цы€	прадукцы€
прадэман-стравала	прадэманстравала
нраекта	праекта
праект-ных	праектных
праскце	праекце
првекце	праекце
Ќраз	праз
нраз	праз
праэ	праз
ѕрдз	ѕраз
пр€з	праз
прай-сц≥	прайсц≥
прай-шл≥	прайшл≥
праншл≥	прайшл≥
прайшоу	прайшоҐ
праншоҐ	прайшоҐ
пра-кладвае	пракладвае
прак-тыку	практыку
практыны	практыцы
прамысло-вай	прамысловай
нрамысловасц≥	прамысловасц≥
пра-мысловасц≥	прамысловасц≥
прамысло-васц≥	прамысловасц≥
прамысло-васць	прамысловасць
нрамысловых	прамысловых
прамысло-вых	прамысловых
пран≥к-л≥	пран≥кл≥
пра-н≥кненне	пран≥кненне
пран≥к-ненн€	пран≥кненн€
пран≥к-нуць	пран≥кнуць
прапаганлаваць	прапагандаваць
прап€г€нду	прапаганду
првпвгвнду	прапаганду
прапа-ганды	прапаганды
пра-панова	прапанова
прапано-ву	прапанову
прана-ноҐ	прапаноҐ
пра-рыҐ	прарыҐ
пра-с≥л≥	прас≥л≥
пра-слав≥Ґ	праслав≥Ґ
пра-слухал≥	праслухал≥
праспент	праспект
прасп€-ваць	прасп€ваць
праста-це	прастаце
прастор-ны	прасторны
пра-стору	прастору
лрасторы	прасторы
прасто-ры	прасторы
пра-с€кнута	прас€кнута
пра-с€кнуты	прас€кнуты
праҐ-да	праҐда
праҐдв	праҐда
ѕраҐла	ѕраҐда
праҐла	праҐда
праҐ-ла	праҐда
прлҐда	праҐда
праҐ-дай	праҐдай
праҐдз≥-ва	праҐдз≥ва
праҐлу	праҐду
праҐлы	праҐды
праҐ-ленне	праҐленне
првҐленне	праҐленне
првҐлен-не	праҐленне
правленн€	праҐленн€
прауленн€	праҐленн€
праҐ-ленн€	праҐленн€
прафссар	прафесар
прафсс≥й	прафес≥й
прлфес≥€	прафес≥€
прафе-с≥€нальных	прафес≥€нальных
прафсс≥€нальных	прафес≥€нальных
нрафсаюзаҐ	прафсаюзаҐ
прафсаюэаҐ	прафсаюзаҐ
прахо-дз≥Ґ	праходз≥Ґ
праходз≥нь	праходз≥ць
праходз€нь	праходз€ць
пра-ходз€ць	праходз€ць
нраца	праца
прана	праца
праца-вал≥	працавал≥
пранаваҐ	працаваҐ
працаааҐ	працаваҐ
пра-цаваҐ	працаваҐ
праца-ваҐ	працаваҐ
нрацаваць	працаваць
пра≥≥аваць	працаваць
пранаваць	працаваць
працаааць	працаваць
працавань	працаваць
праца-вань	працаваць
пра-цаваць	працаваць
праца-ваць	працаваць
працавзць	працаваць
праца-наць	працаваць
працвваць	працаваць
прана-дн€	працадн€
лрацай	працай
#»ћя?	працаҐн≥к≥
пра-цоҐнага	працоҐнага
працоҐ-нага	працоҐнага
пра-цоҐны	працоҐны
пра-цоҐным	працоҐным
працоҐ-ным	працоҐным
пра-цоҐным≥	працоҐным≥
првцоҐным≥	працоҐным≥
лрацоҐных	працоҐных
праноҐных	працоҐных
пра-цоҐных	працоҐных
працоҐ-ных	працоҐных
працоҐпых	працоҐных
пра-цоҐпых	працоҐных
првцоҐных	працоҐных
прлцоҐных	працоҐных
працоҐ-ны€	працоҐны€
пра-цу	працу
лрацуе	працуе
нрацуе	працуе
прануе	працуе
пра-цуе	працуе
працус	працуе
првцуе	працуе
прлцуе	працуе
пра-цую	працую
нрацуюць	працуюць
прануюць	працуюць
працую≥≥ь	працуюць
працуюнь	працуюць
пра-цуюць	працуюць
працу-юць	працуюць
првцуюць	працуюць
нрацы	працы
нра-цы	працы
пра≥≥ы	працы
праны	працы
пра-ны	працы
пра-пы	працы
пра-цы	працы
праць≥	працы
пра-ць≥	працы
првцы	працы
прзцы	працы
прлцы	працы
пр€цы	працы
нрацэнта	працэнта
нрацэнтаҐ	працэнтаҐ
пранэнтаҐ	працэнтаҐ
пра-цэнтаҐ	працэнтаҐ
працэн-таҐ	працэнтаҐ
пра-цэс	працэс
пранэсу	працэсу
працэ-су	працэсу
прац€-гам	прац€гам
нрац€гвае	прац€гвае
прац€гвас	прац€гвае
прац€г-валас€	прац€гвалас€
прац€гвала-с€	прац€гвалас€
пра÷гваюць	прац€гваюць
пра-ц€глы€	прац€глы€
нрац€гу	прац€гу
пран€гу	прац€гу
прлц€гу	прац€гу
нрачытаҐ	прачытаҐ
пра-чытаҐ	прачытаҐ
пра-чытвҐ	прачытаҐ
пра€Ґ-л€е	пра€Ґл€е
пролаж	продаж
про-зв≥шча	прозв≥шча
прозв≥-шча	прозв≥шча
проэв≥шча	прозв≥шча
прозв≥-шчах	прозв≥шчах
прозв≥-шчы	прозв≥шчы
про-зе	прозе
проэы	прозы
лроста	проста
нроста	проста
про-ста	проста
простл	проста
про-стага	простага
про-стай	простай
проста-му	простаму
прос-тую	простую
про-стых	простых
про-сты€	просты€
прось-ба	просьба
прось-бай	просьбай
нры	пры
прыбалты-цы	прыбалтыцы
пры-бл≥зна	прыбл≥зна
пры-бытк≥	прыбытк≥
пры-ватнасц≥	прыватнасц≥
прыват-насц≥	прыватнасц≥
прывесн≥	прывесц≥
прыв≥тан-не	прыв≥танне
прыво-дз≥ць	прыводз≥ць
пры-водэ≥ць	прыводз≥ць
прыво-дз€ш≥а	прыводз€цца
прыву-чыл≥	прывучыл≥
прыга-жоспь	прыгажосць
прыгне-чанн€	прыгнечанн€
прыгн€таль-н≥каҐ	прыгн€тальн≥каҐ
прыгн€тальн≥-каҐ	прыгн€тальн≥каҐ
нрыгожа	прыгожа
пры-гожага	прыгожага
пры-гожа€	прыгожа€
прыго-жа€	прыгожа€
пры-гожы€	прыгожы€
прылумаць	прыдумаць
ѕрысмна	ѕрыемна
прысмна	прыемна
прысмнай	прыемнай
прыЄм-н≥к	прыЄмн≥к
прыЄм-н≥ка	прыЄмн≥ка
прыЄмн≥-ка	прыЄмн≥ка
пры-ехала	прыехала
нрыехал≥	прыехал≥
пры-ехаҐ	прыехаҐ
прысхаҐ	прыехаҐ
пры-знана	прызнана
пры-знацца	прызнацца
прызнань	прызнаць
прыэнаць	прызнаць
пры-з€мленн€	прыз€мленн€
прыз€м-ленн€	прыз€мленн€
прыэ€мленн€	прыз€мленн€
прындзе	прыйдзе
прыншла	прыйшла
прыншл≥	прыйшл≥
#»ћя?	прыйшл≥
нрыклад	прыклад
пры-клад	прыклад
пры-кладна	прыкладна
прыклална	прыкладна
прыкла-дуць	прыкладуць
прыклалы	прыклады
прык-метна	прыкметна
пры-мае	прымае
пры-маҐ	прымаҐ
прымань	прымаць
прыма-юць	прымаюць
пры-ме	прыме
пры-муць	прымуць
прыму-шае	прымушае
прынам-с≥	прынамс≥
прынссла	прынесла
прынос≥нь	прынос≥ць
прыно-с≥ць	прынос≥ць
прыно-с€ць	прынос€ць
прынныпы	прынцыпы
пры-н€ла	прын€ла
пры-н€л≥	прын€л≥
прыпеу	прыпеҐ
пры-пеҐк≥	прыпеҐк≥
нрыроды	прыроды
пры-роды	прыроды
прыро-ды	прыроды
прыролы	прыроды
прысве-чан	прысвечан
прысвсчана	прысвечана
прысвеча-нае	прысвечанае
прысвсча-най	прысвечанай
прысвечвны	прысвечаны
прысвсчаны	прысвечаны
прысвеча-ным	прысвечаным
прысвсчаных	прысвечаных
пры-свечаны€	прысвечаны€
прысве-чаны€	прысвечаны€
прысвеча-ны€	прысвечаны€
пры-своена	прысвоена
пры-св€ц≥Ґ	прысв€ц≥Ґ
пры-стойны	прыстойны
пры-сутнасц≥	прысутнасц≥
прысутн≥-чаюць	прысутн≥чаюць
прысутн≥ча-юць	прысутн≥чаюць
пры-х≥льна	прых≥льна
пры-ходам	прыходам
прыходэ≥ць	прыходз≥ць
пры-чым	прычым
пры€зджаюнь	пры€зджаюць
пры€злжаюць	пры€зджаюць
пры€эджаюць	пры€зджаюць
пры€-рытэт	пры€рытэт
ѕрээ≥дыум	ѕрэз≥дыум
прэ-з≥дыума	прэз≥дыума
прэз≥дыу-ма	прэз≥дыума
прэз≥лыума	прэз≥дыума
ѕрээ≥дыума	ѕрэз≥дыума
прэз≥дэн-ту	прэз≥дэнту
прэм'сру	прэм'еру
прэм'сры	прэм'еры
прэ-м≥€х	прэм≥€х
прэсканферзнцы≥	прэс-канферэнцы≥
прэ-стыж	прэстыж
пунк-там	пунктам
пу-цЄҐках	пуцЄҐках
пу-цЄҐк≥	пуцЄҐк≥
ѕушк≥нв	ѕушк≥на
пы-ла	пыла
пыр-ко	пырко
пы-таемс€	пытаемс€
пы-танне	пытанне
пытаннс	пытанне
нытанн≥	пытанн≥
пы-танн≥	пытанн≥
пытвнн≥	пытанн≥
пытлнн≥	пытанн≥
пытан-н€Ґ	пытанн€Ґ
п€тн≥ну	п€тн≥цу
п€т-роҐна	п€троҐна
п€т-рук	п€трук
п€нь	п€ць
п€пь	п€ць
ра-б≥Ґ	раб≥Ґ
раб≥нь	раб≥ць
ра-б≥ць	раб≥ць
ра-бот	работ
ра-бота	работа
рабо-та	работа
работл	работа
рлбота	работа
ра-ботай	работай
рабо-тай	работай
ра-ботн≥ка	работн≥ка
работн≥-кам	работн≥кам
ра-ботн≥каҐ	работн≥каҐ
работ-н≥каҐ	работн≥каҐ
работн≥клҐ	работн≥каҐ
ра-ботн≥наҐ	работн≥каҐ
рвботн≥каҐ	работн≥каҐ
рвботн≥-каҐ	работн≥каҐ
ра-ботн≥к≥	работн≥к≥
работн≥-к≥	работн≥к≥
рвботн≥к≥	работн≥к≥
рвботн≥-к≥	работн≥к≥
ра-боту	работу
рабо-ту	работу
рвботу	работу
рв-боту	работу
рабогы	работы
ра-боты	работы
рабо-ты	работы
рлботы	работы
рабоне	рабоце
рабоцс	рабоце
ра-боцс	рабоце
рзбоце	рабоце
ра-бочага	рабочага
рабо-чага	рабочага
рабоча-га	рабочага
ра-бочы	рабочы
рабо-чы	рабочы
рабо-чым	рабочым
рабо-чым≥	рабочым≥
рабочы-м≥	рабочым≥
ра-бочых	рабочых
рабо-чых	рабочых
рвбочых	рабочых
ра-бочы€	рабочы€
рабо-чы€	рабочы€
рлбочы€	рабочы€
ра-гу	рагу
ра-гул≥	рагул≥
рагу-л≥	рагул≥
ра-ласна	радасна
ра-даснае	радаснае
радас-нае	радаснае
радас-ным≥	радасным≥
ра-дасны€	радасны€
ра-дасць	радасць
радвсць	радасць
ра-дасцю	радасцю
радз≥-ма	радз≥ма
радэ≥ма	радз≥ма
#»ћя?	радз≥ма
ра-дз≥ме	радз≥ме
–адз≥мс	–адз≥ме
радэ≥ме	радз≥ме
ра-дз≥му	радз≥му
радз≥-му	радз≥му
радэ≥му	радз≥му
≤'адз≥мы	радз≥мы
ра-дз≥мы	радз≥мы
–адз≥мы*	–адз≥мы
радэ≥мы	радз≥мы
–вдз≥мы	–адз≥мы
ра-дуемс€	радуемс€
ра-ды	рады
ра-дыЄ	радыЄ
радыс	радыЄ
ралыЄ	радыЄ
рвдыЄ	радыЄ
ра-дыЄактыҐны	радыЄактыҐны
радыЄактыҐ-ных	радыЄактыҐных
рады€-тары	рады€тары
ра-Єн	раЄн
рлЄн	раЄн
раена	раЄна
раЄнл	раЄна
раЄн€	раЄна
раЄпа	раЄна
рвЄнв	раЄна
рлЄ-на	раЄна
раЄ-наҐ	раЄнаҐ
раЄ-нах	раЄнах
раене	раЄне
рлЄне	раЄне
раЄн-нага	раЄннага
расннага	раЄннага
раЄнн€й	раЄннай
раЄн-на€	раЄнна€
рлЄнных	раЄнных
раэ	раз
разабра≥ша	разабрацца
разабраш≥а	разабрацца
ра-зам	разам
разлм	разам
раз€м	разам
раэам	разам
ра-эам	разам
раэ-бураную	разбураную
разв≥-ваецца	разв≥ваецца
раз-в≥вал≥с€	разв≥вал≥с€
разв≥вац-ца	разв≥вацца
разв≥вань	разв≥ваць
раз-в≥ваюцца	разв≥ваюцца
разв≥-ваючы	разв≥ваючы
разв≥цце	разв≥цце
раз-в≥ццЄ	разв≥ццЄ
разв≥ш≥Є	разв≥ццЄ
раз-в≥цц≥	разв≥цц≥
разв≥ц-ц≥	разв≥цц≥
разв≥ш≥≥	разв≥цц≥
разв≥ш≥ю	разв≥ццю
разв≥≥ш€	разв≥цц€
разв≥нц€	разв≥цц€
раз-в≥цц€	разв≥цц€
разв≥ш≥€	разв≥цц€
раэ-гарнул≥с€	разгарнул≥с€
раз-гл€дам	разгл€дам
раэгрому	разгрому
раздзсл	раздзел
раэзбраенне	раззбраенне
раз-мова	размова
раз-мову	размову
размо-ву	размову
раз-мовы	размовы
раэмовы	размовы
разм€-шчэнне	разм€шчэнне
разм€-шчэнн€	разм€шчэнн€
разна-стайнай	разнастайнай
разнастай-насц≥	разнастайнасц≥
разннстайнасц≥	разнастайнасц≥
ра≥ннстнйны	разнастайны
раэнастайны	разнастайны
разнастай-ных	разнастайных
разн€воле-ным	разн€воленым
ра-зоҐ	разоҐ
раэоҐ	разоҐ
раэумее	разумее
разумсць	разумець
разумеюнь	разумеюць
раэумеюць	разумеюць
ра-зумна	разумна
ра-зумны	разумны
ра-зы	разы
раэы	разы
разыйшл≥с€	разыйшл≥с€
разый-шл≥с€	разыйшл≥с€
ранкома	райкома
рай-прамкамб≥ната	райпрамкамб≥ната
ра-кету	ракету
ра-кеты	ракеты
рама-на	рамана
рлмана	рамана
ра-манаву	раманаву
рамлне	рамане
раман-таваць	рамантаваць
ра-мантычна€	рамантычна€
ра-маны	раманы
ра-монт	рамонт
ра-м€ства	рам€ства
ран€	рана
ра-нак	ранак
ра-ней	раней
ра-нсй	раней
рвней	раней
ра-ны	раны
рап-там	раптам
–ас≤≤	–ас≥≥
ра-с≥≥	рас≥≥
–лс≥≥	–ас≥≥
ра-с≥€	рас≥€
рас-кажа	раскажа
раскаэ	расказ
расказа-л≥	расказал≥
расказань	расказаць
рас-казаць	расказаць
раска-заць	расказаць
раскаэаць	расказаць
рас-казвае	расказвае
расказвзе	расказвае
раскаэвае	расказвае
раскаэ-вае	расказвае
раскдзвае	расказвае
расказваец-ца	расказваецца
расказ-вала	расказвала
рас-казваць	расказваць
расказ-ваць	расказваць
расказнаць	расказваць
расказваюнь	расказваюць
рас-казваюць	расказваюць
раско-пак	раскопак
раскры-вае	раскрывае
раскры-ваць	раскрываць
рас-крыла	раскрыла
рас-крыты	раскрыты
раскрынь	раскрыць
распараджэн-не	распараджэнне
распаҐсюджван-ню	распаҐсюджванню
растлума-чыҐ	растлумачыҐ
растлума-чыць	растлумачыць
рас-туць	растуць
ра-сце	расце
расцс	расце
расн	расы
рацы€нал≥за-тараҐ	рацы€нал≥затараҐ
ра-шучага	рашучага
рашу-чым	рашучым
ра-шэннем	рашэннем
рашэн-нем	рашэннем
ра-шэнн€Ґ	рашэнн€Ґ
рашэн-н€Ґ	рашэнн€Ґ
роб≥ш≥а	роб≥цца
роб≥нь	роб≥ць
ро-б≥ць	роб≥ць
роб€нь	роб€ць
роб€-чы	роб€чы
родна-га	роднага
род-най	роднай
роднан	роднай
роднвй	роднай
роднлй	роднай
ролнай	роднай
ролную	родную
род-ны	родны
ролны	родны
род-ным	родным
род-ны€	родны€
ро-за	роза
роз-думу	роздуму
роз-ным≥	розным≥
роэным≥	розным≥
роз≥≥ых	розных
роз-≥≥ых	розных
роз-ных	розных
роэных	розных
роз-ны€	розны€
роэны€	розны€
ро-эум	розум
ро-зуму	розуму
ро-эуму	розуму
роэу-му	розуму
ро-лю	ролю
ро-сце	росце
ру-бель	рубель
ру-б≥нштэйна	руб≥нштэйна
руо-лЄҐ	рублЄҐ
рубры-кай	рубрыкай
руж-жом	ружжом
ру-жы	ружы
ру-ка	рука
рук€м≥	рукам≥
ру-к≥	рук≥
ру-ку	руку
ру-сака	русака
рус-кага	рускага
рус-кае	рускае
рус-кай	рускай
рус-к≥х	руск≥х
рус-кую	рускую
ру-ху	руху
рыб-кавец	рыбкавец
–мгор	–ыгор
ры-гор	рыгор
рыго-ра	рыгора
рых-туюцца	рыхтуюцца
рыхтуюццв	рыхтуюцца
рыхтуюнь	рыхтуюць
рых-туюць	рыхтуюць
рэа-л≥зму	рэал≥зму
рэал≥эму	рэал≥зму
рэвалюны≥	рэвалюцы≥
рэвллюцы≥	рэвалюцы≥
рэва-люцыйнага	рэвалюцыйнага
рэвалюцый-най	рэвалюцыйнай
рэ-валюцыйным	рэвалюцыйным
рэвалюцый-ных	рэвалюцыйных
рэва-люцыю	рэвалюцыю
рэ-гул€рна	рэгул€рна
рэгу-л€рна	рэгул€рна
рэгул€р-на	рэгул€рна
рэ-дактар	рэдактар
рэлактар	рэдактар
рэдак-тара	рэдактара
рздакцы≥	рэдакцы≥
рэдакны≥	рэдакцы≥
рэдак-цы≥	рэдакцы≥
рэдлкцы≥	рэдакцы≥
рэлакцы≥	рэдакцы≥
–эдакныйна€	рэдакцыйна€
–Ёƒј ÷№ЎЌјя	рэдакцыйна€
рэдакныю	рэдакцыю
рэдак-цыю	рэдакцыю
рэдакны€	рэдакцы€
рэжысвр	рэжысЄр
рэ-жысЄр	рэжысЄр
рэ-жысср	рэжысЄр
рэ-жысЄра	рэжысЄра
рэжысЄ-раҐ	рэжысЄраҐ
рэ-жысЄры	рэжысЄры
рэжысЄ-ры	рэжысЄры
рэзсрвы	рэзервы
рэнорд	рэкорд
рзпертар	рэпертуар
рэпер-туар	рэпертуар
рэпсртуар	рэпертуар
рэ-пертуару	рэпертуару
рэпер-туары	рэпертуары
рэпсртуары	рэпертуары
рэ-петьшы≥	рэпетыцы≥
рэс-публ≥к	рэспубл≥к
рэспуб-л≥к	рэспубл≥к
рэспуб-л≥канскай	рэспубл≥канскай
рэспубл≥кан-скай	рэспубл≥канскай
рэспубл≥-канска€	рэспубл≥канска€
рзспубл≥к≥	рэспубл≥к≥
рэслубл≥к≥	рэспубл≥к≥
рэс-публ≥к≥	рэспубл≥к≥
рэспуб-л≥к≥	рэспубл≥к≥
рэспубл≥-к≥	рэспубл≥к≥
рэспубл≥н≥	рэспубл≥к≥
рэспубл≥÷≥	рэспубл≥к≥
рзспубл≥цы	рэспубл≥цы
рэслубл≥цы	рэспубл≥цы
рэснубл≥цы	рэспубл≥цы
рэспубл≥ны	рэспубл≥цы
рэс-публ≥цы	рэспубл≥цы
рэспуб-л≥цы	рэспубл≥цы
рэспубл≥-цы	рэспубл≥цы
рэнэнз≥≥	рэцэнз≥≥
рэча≥снасн≥	рэча≥снасц≥
рэча≥снаснь	рэча≥снасць
рэча≥с-насць	рэча≥снасць
са-баленка	сабаленка
са-бе	сабе
сабс	сабе
спбе	сабе
са-бой	сабой
са-бою	сабою
сабра-лас€	сабралас€
сабрал≥-с€	сабрал≥с€
са-ве	саве
са-вет	савет
савст	савет
—ааета	—авета
са-вета	савета
саве-та	савета
савста	савета
га-вецкага	савецкага
—ааецкага	—авецкага
сааецкага	савецкага
савенкага	савецкага
савепкага	савецкага
са-вецкага	савецкага
савец-кага	савецкага
савецка-га	савецкага
савецкагв	савецкага
савецкагл	савецкага
савец-к€га	савецкага
—ј¬≈÷Ќ≤ј√ј	савецкага
—авоцкага	—авецкага
савоц-кага	савецкага
савснкага	савецкага
савсн-кага	савецкага
савсцкага	савецкага
савсцка-га	савецкага
са-нецкага	савецкага
—ввецкага	—авецкага
сввецкага	савецкага
сввецквгв	савецкага
сааецкай	савецкай
савенкай	савецкай
—авепкай	—авецкай
са-вецкай	савецкай
савец-кай	савецкай
—авецкан	—авецкай
савсцкай	савецкай
сансцкай	савецкай
сапецкай	савецкай
са-вецкаму	савецкаму
савец-каму	савецкаму
—авенка€	—авецка€
савен-ка€	савецка€
са-вецка€	савецка€
савец-ка€	савецка€
савсцка€	савецка€
сааецк≥	савецк≥
саве≥≥к≥	савецк≥
савенк≥	савецк≥
са-венк≥	савецк≥
са-вецк≥	савецк≥
савец-к≥	савецк≥
савсцк≥	савецк≥
савенк≥м	савецк≥м
савен-к≥м	савецк≥м
савец-к≥м	савецк≥м
савсн-к≥м	савецк≥м
—авсцк≥м	—авецк≥м
савсцк≥м	савецк≥м
савец-к≥м≥	савецк≥м≥
савецк≥-м≥	савецк≥м≥
сааецк≥х	савецк≥х
савенк≥х	савецк≥х
са-венк≥х	савецк≥х
савен-к≥х	савецк≥х
савепк≥х	савецк≥х
са-вецк≥х	савецк≥х
савец-к≥х	савецк≥х
савсцк≥х	савецк≥х
сапецк≥х	савецк≥х
са€ецк≥х	савецк≥х
са-венк≥€	савецк≥€
савепк≥€	савецк≥€
са-вецк≥€	савецк≥€
савец-к≥€	савецк≥€
савсцк≥€	савецк≥€
са-вецкую	савецкую
савсцкую	савецкую
са-€ецкую	савецкую
садзе-€нне	садзе€нне
садруж-насць	садружнасць
са-ду	саду
са-ды	сады
са-ков≥ч	саков≥ч
са-кратар	сакратар
сак-ратар	сакратар
сакра-тар	сакратар
са-кун	сакун
—вкун	—акун
сала-вей	салавей
саламона-ва	саламонава
сал-дат	салдат
сал-даты	салдаты
свле	сале
сал≥с-ты	сал≥сты
са-люту	салюту
свм	сам
слм	сам
свмв	сама
са-мааддана	самааддана
сама-аддана	самааддана
са-мадзейнага	самадзейнага
са-мадзейнасц≥	самадзейнасц≥
самадзей-насц≥	самадзейнасц≥
самадзейнас-ц≥	самадзейнасц≥
самалзейна-сц≥	самадзейнасц≥
самвдзейнвсц≥	самадзейнасц≥
самэдзей-насц≥	самадзейнасц≥
свмвдэейнвсц≥	самадзейнасц≥
самвдзейнвсць	самадзейнасць
самадзейнас-цю	самадзейнасцю
самадзей-ным	самадзейным
сачадзейных	самадзейных
сама-дзейны€	самадзейны€
самадзей-ны€	самадзейны€
са-мае	самае
сама-звалаҐ	самазвалаҐ
са-май	самай
с€м€й	самай
са-малЄт	самалЄт
сама-лЄт	самалЄт
сама-стойнай	самастойнай
самастой-ным	самастойным
са-ма€	сама€
са-м≥	сам≥
слм≥	сам≥
свмы	самы
слмы	самы
са-мым	самым
са-мым≥	самым≥
са-мых	самых
свмых	самых
са-мы€	самы€
св-мы€	самы€
санато-ры€х	санаторы€х
слнтымет-раҐ	сантыметраҐ
сапраҐ-днага	сапраҐднага
сапраҐд-нага	сапраҐднага
сапраҐлнага	сапраҐднага
сапраҐд-най	сапраҐднай
сапраҐд-на€	сапраҐдна€
сапраҐ-дны	сапраҐдны
сапраҐд-ны	сапраҐдны
са-праҐдным	сапраҐдным
салраҐды	сапраҐды
санраҐды	сапраҐды
са-праҐды	сапраҐды
сапраҐлы	сапраҐды
свпраҐды	сапраҐды
с€праҐды	сапраҐды
саракагод-дз€	саракагоддз€
сар-дэчнае	сардэчнае
саҐ-гасаҐ	саҐгасаҐ
саҐ-гасах	саҐгасах
саҐгвсвх	саҐгасах
саҐга-се	саҐгасе
саф-ронава	сафронава
саны€л≥зм	сацы€л≥зм
са-цы€л≥зм	сацы€л≥зм
са-цы€л≥зма	сацы€л≥зма
сацы€-л≥зма	сацы€л≥зма
сацы€л≥з-ма	сацы€л≥зма
сацы€л≥эма	сацы€л≥зма
саны€л≥стычнага	сацы€л≥стычнага
сацы€дст≥чнага	сацы€л≥стычнага
са-цы€л≥стычнага	сацы€л≥стычнага
сацы€л≥-стычнага	сацы€л≥стычнага
сацы€л≥стыч-нага	сацы€л≥стычнага
сацы€л≥стычна-га	сацы€л≥стычнага
саны€л≥стычнай	сацы€л≥стычнай
са-цы€л≥стычнай	сацы€л≥стычнай
сацы€л≥с-тычнай	сацы€л≥стычнай
сацы€л≥стыч-най	сацы€л≥стычнай
—ацы€л≥стычнан	—ацы€л≥стычнай
сацы€л≥-стычна€	сацы€л≥стычна€
сацы€л≥стыч-на€	сацы€л≥стычна€
са-цы€л≥стычную	сацы€л≥стычную
сацы€-л≥стычную	сацы€л≥стычную
са-цы€л≥стычны	сацы€л≥стычны
са-цы€л≥стычным	сацы€л≥стычным
сапы€л≥стычных	сацы€л≥стычных
са-цы€л≥стычных	сацы€л≥стычных
сацы€-л≥стычных	сацы€л≥стычных
сацы€л≥-стычных	сацы€л≥стычных
сацы€л≥с-тычных	сацы€л≥стычных
сацы€л≥стыч-ных	сацы€л≥стычных
са-цы€л≥стычны€	сацы€л≥стычны€
сацы€л≥-стычны€	сацы€л≥стычны€
са-чыл≥	сачыл≥
саюэ	саюз
—люз	—аюз
—аюаа	—аюза
—'аюза	—аюза
са-юза	саюза
саю-за	саюза
—аю≥а	—аюза
саюэа	саюза
—аюэл	—аюза
с€юза	саюза
саю-зам	саюзам
саю-заҐ	саюзаҐ
—аюэе	—аюзе
саюэных	саюзных
свабод-на	свабодна
свабод-ным	свабодным
сва-боду	свабоду
свабо-ду	свабоду
сва-боды	свабоды
сваболы	свабоды
саае	свае
свас	свае
свзе	свае
с€ае	свае
свлЄ	сваЄ
снаЄ	сваЄ
еваЄй	сваЄй
сааЄй	сваЄй
саа-Єй	сваЄй
свабй	сваЄй
сваЄ≥≥	сваЄй
сва-Єй	сваЄй
сваЄн	сваЄй
сваЋй	сваЄй
свасй	сваЄй
свзЄй	сваЄй
свлЄй	сваЄй
св€Єй	сваЄй
снаЄй	сваЄй
спаЄй	сваЄй
с€аЄй	сваЄй
сваЄйтворчасц≥	сваЄй творчасц≥
саа≥м	сва≥м
сва-≥м	сва≥м
свв≥м	сва≥м
свл≥м	сва≥м
св€≥м	сва≥м
с€а≥м	сва≥м
саа≥м≥	сва≥м≥
свл≥м≥	сва≥м≥
с€а≥м≥	сва≥м≥
саа≥х	сва≥х
сва-≥х	сва≥х
свв≥х	сва≥х
свл≥х	сва≥х
свл-≥х	сва≥х
св€≥х	сва≥х
св€-≥х	сва≥х
сна≥х	сва≥х
сна-≥х	сва≥х
спа≥х	сва≥х
с€а≥х	сва≥х
саайго	свайго
сва≥≥го	свайго
свай-го	свайго
сванго	свайго
сван-го	свайго
свлйго	свайго
св€йго	свайго
свай-му	свайму
сввту	свату св€ту
сааю	сваю
сввю	сваю
свзю	сваю
свлю	сваю
св€ю	сваю
свед-кам	сведкам
свед-чаць	сведчаць
свелчаць	сведчаць
свсдчаць	сведчаць
свед-чыць	сведчыць
свелчыць	сведчыць
свсжай	свежай
сает	свет
свст	свет
све-там	светам
свет-лай	светлай
свет-лы	светлы
све-ту	свету
свсту	свету
гвеце	свеце
свене	свеце
све-це	свеце
свецс	свеце
свсце	свеце
св≥-нарн≥к	св≥нарн≥к
своечасо-ва	своечасова
саой	свой
сво≥≥	свой
свон	свой
са€дома-сц≥	св€домасц≥
св€домасн≥	св€домасц≥
св€до-масц≥	св€домасц≥
св€-та	св€та
св€-точны€	св€точны€
св€-ты	св€ты
св€-шчэннай	св€шчэннай
сезонс	сезоне
сезо-нс	сезоне
сЄ-лета	сЄлета
сслета	сЄлета
сЄ-летн≥м	сЄлетн≥м
сельгасарнел≥	сельгасарцел≥
сельгасарце-л≥	сельгасарцел≥
сельсаве-та	сельсавета
сельска-гаспадарчай	сельскагаспадарчай
сельскагаспа-дарчай	сельскагаспадарчай
сельскагаспадарчан	сельскагаспадарчай
сельскагаспаларчай	сельскагаспадарчай
ссльскагаспадарчай	сельскагаспадарчай
сельскаг€спадарча€	сельскагаспадарча€
сельска-гаспадарчых	сельскагаспадарчых
сельскагас-падарчых	сельскагаспадарчых
сель-скай	сельскай
сельскан	сельскай
сельсквй	сельскай
сельснай	сельскай
ссльскай	сельскай
сель-ск≥х	сельск≥х
ссльск≥х	сельск≥х
ссльскую	сельскую
сел€н≥-на	сел€н≥на
ссл€н≥на	сел€н≥на
сем'1	сем'≥
ссм≥нар	сем≥нар
се-м€н€к≥	сем€н€к≥
сЄн-≥≥€	сЄнн€
сенн€	сЄнн€
сЄн-н€	сЄнн€
сснн€	сЄнн€
сЄн-н€шн€га	сЄнн€шн€га
сЄ-стры	сЄстры
—≤г≥змундав≥ч	—≥г≥змундав≥ч
с≥г≥з-мундав≥ч	с≥г≥змундав≥ч
с≥л€й	с≥лай
с≥ла-м≥	с≥лам≥
с≥-лы	с≥лы
с≥-манава	с≥манава
с≥мфа-н≥чнага	с≥мфан≥чнага
с≥-стэма	с≥стэма
с≥-стэматычна	с≥стэматычна
с≥стэматыч-на	с≥стэматычна
с≥-стэму	с≥стэму
с≥стзмы	с≥стэмы
с≥стэ-мы	с≥стэмы
ска-жам	скажам
скажлм	скажам
ск€ж€м	скажам
ска-зала	сказала
скаэана	сказана
ска-заҐ	сказаҐ
сказзҐ	сказаҐ
скаэаҐ	сказаҐ
ска-эаҐ	сказаҐ
сказа≥≥ь	сказаць
сказань	сказаць
сказапь	сказаць
ска-заць	сказаць
сказвць	сказаць
скаэаць	сказаць
скдзаць	сказаць
скан-чэнн€	сканчэнн€
сквр-г≥	скарг≥
скаро-чаны	скарочаны
склчок	скачок
склада-най	складанай
скла-даны€	складаны€
складаюнь	складаюць
скла-ду	складу
скончы-лас€	скончылас€
скульнтараҐ	скульптараҐ
скульнтуры	скульптуры
слаҐнан	слаҐнай
слаҐ-ных	слаҐных
слаҐ-ны€	слаҐны€
слсд	след
сле-ду	следу
сле-сар	слесар
сле-сары	слесары
сл≥-вы	сл≥вы
сло-ва	слова
словв	слова
словл	слова
слов€	слова
слона	слова
слоаам	словам
словлм	словам
слоаы	словы
словм	словы
сло-вм	словы
сло€ы	словы
слоҐ-н≥к	слоҐн≥к
слоҐ-н≥ка	слоҐн≥ка
слу-жачых	служачых
служа-чых	служачых
служ-бу	службу
служынь	служыць
слу-жыць	служыць
служэн-ню	служэнню
—лухайцс	—лухайце
слу-хал≥	слухал≥
слу-хаць	слухаць
слуха-ча	слухача
слуха-чам	слухачам
слуцка-га	слуцкага
сма-ленскай	смаленскай
смален-скай	смаленскай
сме-лы	смелы
смернь	смерць
смерню	смерцю
см≥р-ноҐ	см≥рноҐ
см€-лей	см€лей
—окала утылоҐскага	—окала- утылоҐскага
сонеч-ны€	сонечны€
сон-ца	сонца
сонцл	сонца
со-рак	сорак
союэа	союза
спаборн≥нтва	спаборн≥цтва
спа-борн≥нтва	спаборн≥цтва
спаборн≥цтаа	спаборн≥цтва
спаборн≥цт-ва	спаборн≥цтва
спаборн≥цтае	спаборн≥цтве
спабор-н≥цтве	спаборн≥цтве
спабор-н≥чаюць	спаборн≥чаюць
спада-рожн≥к	спадарожн≥к
спа-дарожн≥ка	спадарожн≥ка
спада-рожн≥ка	спадарожн≥ка
спада-рожн≥к≥	спадарожн≥к≥
спад-чыны	спадчыны
спа-кою	спакою
спале-ны	спалены
спа-л≥л≥	спал≥л≥
спань	спаць
спа-чатку	спачатку
спачат-ку	спачатку
спек-таклем	спектаклем
слек-такл≥	спектакл≥
спек-такл≥	спектакл≥
спектвкл≥	спектакл≥
спсктакл≥	спектакл≥
спск-такл≥	спектакл≥
—псктакль	—пектакль
спсктакль	спектакль
спск-такль	спектакль
спектак-л€	спектакл€
спектвкл€	спектакл€
спсктакл€	спектакл€
спек-такл€Ґ	спектакл€Ґ
спсктакл€Ґ	спектакл€Ґ
спек-такл€х	спектакл€х
спсктакл€х	спектакл€х
спецы€-л≥стам≥	спецы€л≥стам≥
спены€л≥стаҐ	спецы€л≥стаҐ
спецы€л≥-стаҐ	спецы€л≥стаҐ
спсцы€л≥стаҐ	спецы€л≥стаҐ
спецы€-л≥сты	спецы€л≥сты
спены€льна	спецы€льна
спецы-€льны	спецы€льны
спе-цы€льным	спецы€льным
спе-цы€лы≥ы€	спецы€льны€
снрава	справа
спра-ва	справа
спрана	справа
спран€	справа
справа-м≥	справам≥
слраве	справе
снраве	справе
спра-ве	справе
справс	справе
спрлве	справе
снраву	справу
спра-ву	справу
снравы	справы
спра-аы	справы
справм	справы
спра-вы	справы
спрапы	справы
спрввы	справы
спрлвы	справы
справ€д-л≥васц≥	справ€дл≥васц≥
справ€дл≥ву≥о	справ€дл≥вую
спро-ба	спроба
спры-€льны€	спры€льны€
слрэчк≥	спрэчк≥
спы-н≥ць	спын≥ць
спы-таҐс€	спытаҐс€
сп€-ванн€	сп€ванн€
сп€-ваць	сп€ваць
сп€-шацца	сп€шацца
сродка-м≥	сродкам≥
сролкаҐ	сродкаҐ
сролк≥	сродк≥
ста-в≥цца	став≥цца
став≥нь	став≥ць
стагод-дз≥	стагоддз≥
ста-годдз€	стагоддз€
стаголдз€	стагоддз€
ствгоддз€Ґ	стагоддз€Ґ
ста≥нь	ста≥ць
ста-≥ць	ста≥ць
ста-лага	сталага
ста-л≥	стал≥
ста-л≥на	стал≥на
етал≥цы	стал≥цы
ста-л≥цы	стал≥цы
стал≥-цы	стал≥цы
ствл≥цы	стал≥цы
ста-ловай	сталовай
ста-не	стане
ста-нов≥шча	станов≥шча
стано-в≥шча	станов≥шча
стано-в€цца	станов€цца
станунь	стануць
ста-нуць	стануць
станны≥	станцы≥
стан-цы≥	станцы≥
старажыт-нага	старажытнага
старажыт-най	старажытнай
ста-ранна	старанна
ста-рой	старой
ста-ронак	старонак
ста-ронках	старонках
старон-ках	старонках
старшынл	старшына
стар-шынЄй	старшынЄй
стар-шын≥	старшын≥
стар-шыню	старшыню
стар-шын€	старшын€
старшы-н€	старшын€
ствршын€	старшын€
ста-рым	старым
ста-рых	старых
старэй-шы€	старэйшы€
стаҐлен-не	стаҐленне
ста€нь	ста€ць
ста-€ць	ста€ць
ствараль-н≥кам	стваральн≥кам
стваральнкам≥	стваральн≥кам≥
стварань	ствараць
стаарыҐ	стварыҐ
стаарыць	стварыць
стварынь	стварыць
ства-рынь	стварыць
ства-рыць	стварыць
стаарэнне	стварэнне
ства-рэнн≥	стварэнн≥
стварэн-н≥	стварэнн≥
ства-рэнню	стварэнню
ства-рэнн€	стварэнн€
стварэн-н€	стварэнн€
створа-на	створана
ство-ранай	створанай
створа-на€	створана€
стаораны	створаны
ство-ранм	створаны
ство-рвны	створаны
стнораны	створаны
столь-к≥	стольк≥
страс-ны	страсны
страҐн≥кавак≥шэчных	страҐн≥кава-к≥шэчных
стран≥л≥	страц≥л≥
стронцый90	стронцый 90
студзень-скага	студзеньскага
студзень-ск≥	студзеньск≥
сту-ды≥	студы≥
стулы€	студы€
сту-дэнтам≥	студэнтам≥
стулэнтаҐ	студэнтаҐ
студзнты	студэнты
сту-дэнты	студэнты
студэн-ты	студэнты
сты-л≥	стыл≥
—”јЌ„џЌЌ≤ јћ≤	суайчынн≥кам≥
суанчын-н≥к≥	суайчынн≥к≥
суботлх	суботах
суверэн≥-тэту	суверэн≥тэту
су-в€зей	сув€зей
—”¬я«≈ѕ	сув€зей
сув€эей	сув€зей
су-в€з≥	сув€з≥
сув€э≥	сув€з≥
су-в€зь	сув€зь
су≥с-наванне	су≥снаванне
су-месна	сумесна
сум-ленне	сумленне
сумлен-н€	сумленн€
сум-ненн€	сумненн€
сумнснн€	сумненн€
супраноҐн≥к	супрацоҐн≥к
супра-цоҐн≥к	супрацоҐн≥к
супрацоҐн≥-каҐ	супрацоҐн≥каҐ
супрацоҐн≥ц-тва	супрацоҐн≥цтва
су-нраць	супраць
супрань	супраць
су-прань	супраць
суп-рань	супраць
супрапь	супраць
су-праць	супраць
суп-раць	супраць
супрвць	супраць
супрлць	супраць
суп€рэчнасн≥	суп€рэчнасц≥
сур'Єэна	сур'Єзна
сур'сэна	сур'Єзна
суро-вага	суровага
суро-вай	суровай
су-ровы€	суровы€
су-светнага	сусветнага
сусвет-нага	сусветнага
сусветна-га	сусветнага
су-светнай	сусветнай
сус-ветнай	сусветнай
сусвет-най	сусветнай
сусветнвй	сусветнай
сусвет-ны	сусветны
еусветных	сусветных
сусветмых	сусветных
су-свету	сусвету
сустракас	сустракае
сустрака-ем	сустракаем
сустрака-л≥с€	сустракал≥с€
су-стракаюцца	сустракаюцца
сустра-каюць	сустракаюць
сустракаючы-с€	сустракаючыс€
сустрзл≥	сустрэл≥
сустрэл≥-с€	сустрэл≥с€
суст-рэне	сустрэне
су-стрэҐ	сустрэҐ
су-стрэць	сустрэць
су-стрэч	сустрэч
сустрзчу	сустрэчу
сустрэчм	сустрэчы
суст-рэчы	сустрэчы
сустрэ-чы	сустрэчы
сутнасн≥	сутнасц≥
сутна-сц≥	сутнасц≥
сутнаснь	сутнасць
сут-насць	сутнасць
су-часнае	сучаснае
сучас-нае	сучаснае
сучаснас	сучаснае
су-часнай	сучаснай
сучас-най	сучаснай
сучаснасн≥	сучаснасц≥
сучас-насц≥	сучаснасц≥
сучаснаснь	сучаснасць
сучас-насць	сучаснасць
сучаснасню	сучаснасцю
су-часн≥к	сучасн≥к
су-часную	сучасную
су-часны	сучасны
сучас-ным≥	сучасным≥
су-часных	сучасных
схе-му	схему
схо-дзе	сходзе
сходзс	сходзе
снв€рджае	сцв€рджае
сцв€р-джае	сцв€рджае
сцв€рлжае	сцв€рджае
сцв€р-джаецца	сцв€рджаецца
сце-нам≥	сценам≥
снэн	сцэн
снэна	сцэна
снэнарый	сцэнарый
снэ-нарый	сцэнарый
снэне	сцэне
сцэ-не	сцэне
сцэнс	сцэне
сцэ-н≥чнага	сцэн≥чнага
снэн≥чнай	сцэн≥чнай
сцэ-ну	сцэну
снэны	сцэны
снэ-ны	сцэны
сц€-га	сц€га
сц€га-носцам	сц€ганосцам
сн€не	сц€не
сы-нам	сынам
сэрна	сэрца
сэр-ца	сэрца
сзрцам	сэрцам
сэрнам	сэрцам
сэр-цам	сэрцам
сэр-ны	сэрцы
сюлы	сюды
сюжэ-та	сюжэта
с€-бе	с€бе
с€бо	с€бе
с€бс	с€бе
с€брв	с€бра
с€броу	с€броҐ
с€б-руе	с€бруе
с€б-ры	с€бры
с€-джу	с€джу
с€дзсл≥	с€дзел≥
с€дз≥нь	с€дз≥ць
с€дз€нь	с€дз€ць
с€-ло	с€ло
с€лан	с€л€н
с€-л€нства	с€л€нства
с€мЄ-нав≥ч	с€мЄнав≥ч
с€-м≥	с€м≥
с€м'1	с€м'≥
с€-м≥годк≥	с€м≥годк≥
с€м≥-годк≥	с€м≥годк≥
с€м≥год-к≥	с€м≥годк≥
с€-м≥годку	с€м≥годку
семнаццаць	с€мнаццаць
с€ргее-в≥ч	с€ргеев≥ч
—€ргесв≥ч	—€ргеев≥ч
—€ргсев≥ч	—€ргеев≥ч
—€рген	—€ргей
—нрод	с€род
с€-род	с€род
с€рол	с€род
с€рэднлй	с€рэднай
с€рэд-н≥м	с€рэдн≥м
с€рэлн≥х	с€рэдн≥х
с€-рэднюю	с€рэднюю
с€-рэдн€й	с€рэдн€й
с€рэд-н€й	с€рэдн€й
с€рэдн€н	с€рэдн€й
с€рэлн€й	с€рэдн€й
с€-стру	с€стру
с€-стры	с€стры
та-бе	табе
табс	табе
твбе	табе
тзбе	табе
та-вараҐ	тавараҐ
тава-раҐ	тавараҐ
та-варыш	таварыш
та-варыша	таварыша
тава-рышам	таварышам
тава-рышаҐ	таварышаҐ
тавары-шаҐ	таварышаҐ
тава-рышу	таварышу
тавары-шу	таварышу
тавары-шы	таварышы
таварышы≥	таварышы
гаго	таго
та-го	таго
твго	таго
тзго	таго
тлго	таго
та-ды	тады
твды	тады
т€ды	тады
тах	так
твк	так
тлк	так
“лк	“ак
т€к	так
твк≥	так≥
гак≥м	так≥м
твк≥м	так≥м
тлк≥м	так≥м
т€к≥м	так≥м
гак≥м≥	так≥м≥
гак≥х	так≥х
тлк≥х	так≥х
гак≥€	так≥€
та-к≥€	так≥€
твк≥€	так≥€
та-кога	такога
таког€	такога
та-кое	такое
такос	такое
та-кой	такой
твкой	такой
гаксама	таксама
так-сама	таксама
такса-ма	таксама
таксамв	таксама
таксамл	таксама
таксам€	таксама
так-сам€	таксама
таксвма	таксама
таксзма	таксама
твксвмв	таксама
тзксама	таксама
тлксама	таксама
т€ксама	таксама
та-кую	такую
та-ленав≥тага	таленав≥тага
таленав≥-ты	таленав≥ты
твлент	талент
та-лентаҐ	талентаҐ
твлен-твҐ	талентаҐ
та-лы	талы
твм	там
тлм	там
“лм	“ам
т€м	там
та-му	таму
“вму	“аму
твму	таму
тлму	таму
т€му	таму
тансц	танец
таннаҐ	танцаҐ
тапа-леҐск≥	тапалеҐск≥
“ан€на	“ац€на
та-ц€на	тац€на
га€мн≥цы	та€мн≥цы
та€мн≥-чы	та€мн≥чы
гва≥м	тва≥м
гвайго	твайго
гвор	твор
таор	твор
гвора	твора
тво-ра	твора
таорам≥	творам≥
тво-рам≥	творам≥
твора-м≥	творам≥
гвораҐ	твораҐ
таораҐ	твораҐ
тво-раҐ	твораҐ
творлҐ	твораҐ
тнораҐ	твораҐ
гворах	творах
таорах	творах
тво-рах	творах
творвх	творах
тпорах	творах
таорчай	творчай
твор-чай	творчай
тнорчай	творчай
гворчасц≥	творчасц≥
таорчасц≥	творчасц≥
творчасн≥	творчасц≥
творчасп≥	творчасц≥
твор-часц≥	творчасц≥
творчас-ц≥	творчасц≥
творчлсц≥	творчасц≥
“ворчаснь	“ворчасць
творчаснь	творчасць
твор-часць	творчасць
таорча€	творча€
твор-чую	творчую
таорчы	творчы
твор-чы	творчы
таорчым	творчым
твор-чым≥	творчым≥
творчы-м≥	творчым≥
гворчых	творчых
таорчы€	творчы€
твор-чы€	творчы€
таоры	творы
творм	творы
тво-ры	творы
тво--ры	творы
тноры	творы
т€оры	творы
тка-н≥н	ткан≥н
ткачоу	ткачоҐ
тлума-чыць	тлумачыць
тос	тое
то≥≥	той
гольк≥	тольк≥
тольк1	тольк≥
толь-к≥	тольк≥
тольн≥	тольк≥
толь-н≥	тольк≥
тольч≥	тольк≥
тпльк≥	тольк≥
трады-цы≥	традыцы≥
тралыцый	традыцый
трактарна-га	трактарнага
трак-тарыстам	трактарыстам
тра-п≥ць	трап≥ць
трац≥нь	трац≥ць
трох-≥	трох≥
трн	тры
тры-буну	трыбуну
тры-буны	трыбуны
трыва-лай	трывалай
трыво-г≥	трывог≥
трыс-та	трыста
тры-умф	трыумф
грэба	трэба
трзба	трэба
трэ-ба	трэба
трэбв	трэба
трэ-бв	трэба
трэбз	трэба
трэбл	трэба
“рэбл	“рэба
трэб€	трэба
трэ-ц€га	трэц€га
тудысюды	туды-сюды
ту-рыст	турыст
ту-рысты	турысты
турыс-ты	турысты
ты-дзень	тыдзень
гым	тым
тмс€ч	тыс€ч
ты-с€ч	тыс€ч
ты-с€чы	тыс€чы
тыс€-чы	тыс€чы
ты-тул	тытул
тышке-в≥ча	тышкев≥ча
тэарэтыч-най	тэарэтычнай
гэатр	тэатр
тэ-атр	тэатр
тэвтр	тэатр
гэатра	тэатра
тзатра	тэатра
тэагра	тэатра
тэ-атра	тэатра
тэат-ра	тэатра
тэатрв	тэатра
тэатрл	тэатра
тэвтра	тэатра
тэлтра	тэатра
тэ€тра	тэатра
тэатралы≥ага	тэатральнага
тэат-ралы≥ага	тэатральнага
тэ-атральнага	тэатральнага
“эатральнамастацкага	тэатральна-мастацкага
тэатральнамастацкага	тэатральна-мастацкага
тэатральнамастацк≥м	тэатральна-мастацк≥м
тэат-ральным	тэатральным
тэат-ральных	тэатральных
тэатраль-ных	тэатральных
тэатралы≥ы€	тэатральны€
тэ-атральны€	тэатральны€
тэат-рам≥	тэатрам≥
гэатраҐ	тэатраҐ
тэат-раҐ	тэатраҐ
гэатры	тэатры
тзатры	тэатры
тэ-атры	тэатры
тэвтры	тэатры
тэлтры	тэатры
тэ€тры	тэатры
тэк-стаҐ	тэкстаҐ
тэк-сты	тэксты
тэлебачаннс	тэлебачанне
тэлсбачанн€	тэлебачанн€
тэлегра-фа	тэлеграфа
тэле-фоне	тэлефоне
“эпефоны	“элефоны
“эльјв≥ва	“эль-јв≥ва
“эльјв≥ве	“эль-јв≥ве
тэм€	тэма
тэ-май	тэмай
тэма-тычны	тэматычны
тэма-тычных	тэматычных
тэма-тычны€	тэматычны€
тэ-му	тэму
тэх-н≥ка	тэхн≥ка
тэхн≥-кай	тэхн≥кай
тэхн≥-кум	тэхн≥кум
тэхн≥ч-ны	тэхн≥чны
тэхн≥ч-ным	тэхн≥чным
тэх-н≥чных	тэхн≥чных
уба-чаць	убачаць
уба-чыць	убачыць
убран-н≥	убранн≥
уввг≥	уваг≥
ув€г≥	уваг≥
увссь	увесь
удало-с€	удалос€
удзсльн≥каҐ	удзельн≥каҐ
удзелы≥≥к≥	удзельн≥к≥
удзелы≥≥-к≥	удзельн≥к≥
удзельн≥-к≥	удзельн≥к≥
”дзельн≥м≥	удзельн≥к≥
удзсльн≥к≥	удзельн≥к≥
удзель-н≥чал≥	удзельн≥чал≥
удзельн≥чань	удзельн≥чаць
удз€ч-ны	удз€чны
уз-броеным	узброеным
уэдымам	уздымам
уэнагародз≥Ґ	узнагародз≥Ґ
уэн≥м≥цес€	узн≥м≥цес€
узрада-ваҐс€	узрадаваҐс€
узрас-ла	узрасла
узрас-тае	узрастае
уэ€Ґ	уз€Ґ
уэ€ць	уз€ць уп€ць
уклю-чыць	уключыць
укра-≥нскага	укра≥нскага
украннскмй	укра≥нскай
уксу-саҐ	уксусаҐ
ула-дз≥м≥р	уладз≥м≥р
уладз≥-м≥р	уладз≥м≥р
уладэ≥м≥р	уладз≥м≥р
ула-дэ≥м≥р	уладз≥м≥р
ула-дз≥м≥ра	уладз≥м≥ра
”лад≥≥м≥ра	”ладз≥м≥ра
ула-дз≥м≥рам	уладз≥м≥рам
уладз≥-м≥рам	уладз≥м≥рам
ула-ды	улады
уль€-наҐск	уль€наҐск
ума-цоҐвайце	умацоҐвайце
уме-ла	умела
умсла	умела
умонах	умовах
ун≥всрс≥тэт	ун≥верс≥тэт
ун≥вер-с≥тэце	ун≥верс≥тэце
ун≥всрс≥-тэце	ун≥всрс≥тэце
упар-тай	упартай
упе-рад	уперад
упер-шыню	упершыню
упершы-ню	упершыню
упсршыню	упершыню
упраҐ-ленн€	упраҐленн€
ура-жанне	уражанне
ураж€ннем	уражаннем
усс	усе
”сс	”се
усв	усЄ
усе-саюзнай	усесаюзнай
усмсшкай	усмешкай
успам≥-наҐ	успам≥наҐ
успом-н≥м	успомн≥м
уств-нове	установе
уста-ноҐ	устаноҐ
уствноҐ	устаноҐ
уств-ноҐ	устаноҐ
устаноҐ-лены	устаноҐлены
ус-ход	усход
усю-ды	усюды
усюлы	усюды
ус€-го	ус€го
у€Ґ-ленне	у€Ґленне
Ґблчыл≥	Ґбачыл≥
Ґба-чыць	Ґбачыць
Ґва-г≥	Ґваг≥
Ґва-зе	Ґвазе
Ґвай-шоҐ	ҐвайшоҐ
Ґва-ходз≥ць	Ґваходз≥ць
Ґвссь	Ґвесь
Ґда-ла	Ґдала
Ґдало-с€	Ґдалос€
Ґдзсл	Ґдзел
Ґдэел	Ґдзел
Ґдзсльн≥каҐ	Ґдзельн≥каҐ
Ґдз€ч-насць	Ґдз€чнасць
Ґдз€ч-ны	Ґдз€чны
Ґзбраен-н€Ґ	Ґзбраенн€Ґ
Ґз-дыму	Ґздыму
Ґзды-му	Ґздыму
Ґзна-чальвае	Ґзначальвае
Ґзначаль-вае	Ґзначальвае
Ґзро-вень	Ґзровень
Ґэросту	Ґзросту
Ґз€-лас€	Ґз€лас€
Ґз€Ґ-с€	Ґз€Ґс€
Ґка-раненн€	Ґкараненн€
Ґма-цаванне	Ґмацаванне
Ґмаца-ванне	Ґмацаванне
Ґма-цаванн€	Ґмацаванн€
Ґмо-вы	Ґмовы
Ґнутра-най	Ґнутранай
Ґпер-шыню	Ґпершыню
ҐпраҐ-ленн€	ҐпраҐленн€
Ґра-да	Ґрада
Ґра-даҐ	ҐрадаҐ
Ґра-джай	Ґраджай
Ґра-жанне	Ґражанне
Ґражан-н€м≥	Ґражанн€м≥
Ґрачыс-тае	Ґрачыстае
Ґсс	Ґсе
ҐеЄ	ҐсЄ
Ґсб	ҐсЄ
Ґсе-агульнага	Ґсеагульнага
Ґссй	Ґсей
Ґсена-роднай	Ґсенароднай
Ґсесаюз-най	Ґсесаюзнай
Ґс≥-м≥	Ґс≥м≥
Ґсм≥хаец-ца	Ґсм≥хаецца
Ґспам≥нм	Ґспам≥ны
Ґспа-м≥ны	Ґспам≥ны
Ґспам≥-ны	Ґспам≥ны
Ґспом-н≥ць	Ґспомн≥ць
Ґстал€-валас€	Ґстал€валас€
Ґста-ноҐ	ҐстаноҐ
Ґста-юць	Ґстаюць
Ґсв	Ґс€
Ґс€-го	Ґс€го
Ґс€гэ	Ґс€го
Ґтварэн-н€	Ґтварэнн€
Ґце-кача	Ґцекача
Ґча-стка	Ґчастка
Ґчаст-ка	Ґчастка
Ґша-ноҐвае	ҐшаноҐвае
Ґ€Ґ-ленне	Ґ€Ґленне
фаб-рыках	фабрыках
фабры-ках	фабрыках
фаб-рык≥	фабрык≥
фабрыны	фабрыцы
фаб-рыцы	фабрыцы
фа-культэта	факультэта
флльклору	фальклору
фартэп≥€-на	фартэп≥€на
фата-граф≥≥	фатаграф≥≥
фашыз-мам	фашызмам
фашы-стаҐ	фашыстаҐ
фа-шысты	фашысты
фа-шысцкай	фашысцкай
фа-шысцк≥х	фашысцк≥х
фа-шысцк≥€	фашысцк≥€
фЄ-дар	фЄдар
фЄда-рам	фЄдарам
фЄда-раҐ	фЄдараҐ
фе-дэратыҐнай	федэратыҐнай
фелье-тоны	фельетоны
фер-ме	ферме
ф≥э≥чнай	ф≥з≥чнай
ф≥з≥€лаг≥ч-ны	ф≥з≥€лаг≥чны
ф≥-лармон≥≥	ф≥лармон≥≥
ф≥лврмон≥≥	ф≥лармон≥≥
ф≥ль-маҐ	ф≥льмаҐ
ф≥льмс	ф≥льме
ф≥ль-мы	ф≥льмы
фор-май	формай
фор-ме	форме
формс	форме
фор-мы	формы
фран-цузскай	французскай
фран-цузы	французы
фра≥шы≥	францы≥
ф|юнта	фронта
фрон-та	фронта
фрон-там	фронтам
фро≥ше	фронце
ха-дз≥Ґ	хадз≥Ґ
хадз≥нь	хадз≥ць
ха-лоднай	халоднай
халае	хапае
ха-пае	хапае
хапас	хапае
ха-равы	харавы
хара-вы€	харавы€
харакгар	характар
ха-рактар	характар
ха-рактараҐ	характараҐ
харак-тараҐ	характараҐ
характа-раҐ	характараҐ
характа-ру	характару
хврактару	характару
х€рактару	характару
ха-рактары	характары
характа-ры	характары
характа-рыстыка	характарыстыка
ха-рактэрны	характэрны
характэр-ных	характэрных
хармай-стар	хармайстар
хат-н≥х	хатн≥х
ха-це	хаце
ханелас€	хацелас€
ха-целас€	хацелас€
хаце-лас€	хацелас€
хацела-с€	хацелас€
хацслас€	хацелас€
’ацслас€	’ацелас€
хаал≥	хвал≥
хвлл≥	хвал≥
хва-люе	хвалюе
хвалюс	хвалюе
хвалююнь	хвалююць
хва-люючую	хвалюючую
хвал€-вал≥с€	хвал€вал≥с€
хвал€-ванне	хвал€ванне
хаал€х	хвал€х
хва-л€х	хвал€х
хв≥-л≥н	хв≥л≥н
хво-ры€	хворы€
х≥бв	х≥ба
х≥-м≥≥	х≥м≥≥
хлсб	хлеб
хле-ба	хлеба
хлсба	хлеба
хле-бам	хлебам
хлопсц	хлопец
хлоп-цы	хлопцы
хлопчмк	хлопчык
ходз≥нь	ходз≥ць
ходэ≥ць	ходз≥ць
ходз€нь	ходз€ць
хо-дз€ць	ходз€ць
хо-ру	хору
хонь	хоць
хо-ча	хоча
хоча≥ша	хочацца
хочанца	хочацца
хо-чацца	хочацца
хочаш≥а	хочацца
хо-чуць	хочуць
хран≥кальнадакументальных	хран≥кальна-дакументальных
хру-шчова	хрушчова
хрушчо-ва	хрушчова
’рушчовв	’рушчова
хру-шчову	хрушчову
хру-шчоҐ	хрушчоҐ
хрушчэҐ	хрушчоҐ
хут-ка	хутка
хуткв	хутка
хут-касцю	хуткасцю
хут-чэй	хутчэй
хутчэй-шага	хутчэйшага
цал≥н-ных	цал≥нных
цал≥н-ны€	цал≥нны€
цал≥-ну	цал≥ну
цал-кам	цалкам
цЄм-к≥на	цЄмк≥на
цемрм	цемры
нЄплы€	цЄплы€
ц≥ка-ва	ц≥кава
ц≥-кавага	ц≥кавага
ц≥каваснь	ц≥кавасць
ц≥ка-васць	ц≥кавасць
ц≥кавасню	ц≥кавасцю
ц≥-кавасцю	ц≥кавасцю
ц≥ка-васцю	ц≥кавасцю
ц≥кавас-цю	ц≥кавасцю
ц≥-кава€	ц≥кава€
ц≥кав≥нь	ц≥кав≥ць
ц≥ка-в≥ць	ц≥кав≥ць
ц≥-кавы	ц≥кавы
ц≥ка-вы	ц≥кавы
ц≥кавы-м≥	ц≥кавым≥
ц≥-кавых	ц≥кавых
ц≥ка-вых	ц≥кавых
ц≥ка-вы€	ц≥кавы€
цудоҐ-на	цудоҐна
цу-доҐна€	цудоҐна€
цудоҐ-на€	цудоҐна€
нудоҐны	цудоҐны
цу-доҐны	цудоҐны
нудоҐных	цудоҐных
цу-доҐны€	цудоҐны€
цулоҐны€	цудоҐны€
нук-ровы€	цукровы€
цурба-коҐ	цурбакоҐ
нымбалаҐ	цымбалаҐ
нэлым	цэлым
цэ-лым	цэлым
нэнтнераҐ	цэнтнераҐ
цэнт-ра	цэнтра
цэнт-ральнага	цэнтральнага
цэн-тральнай	цэнтральнай
цэнтраль-най	цэнтральнай
цэнт-ральнаму	цэнтральнаму
цэнт-ральны	цэнтральны
нэнтры	цэнтры
ц€-бе	ц€бе
ц€бс	ц€бе
ц€-гне	ц€гне
ц€гнец-ца	ц€гнецца
н€жка	ц€жка
ц€жкв	ц€жка
ц€жкл	ц€жка
ц€жк€	ц€жка
ц€жкасн≥	ц€жкасц≥
н€жк≥	ц€жк≥
ц€ж-к≥м	ц€жк≥м
ц€ж-к≥х	ц€жк≥х
н€жкую	ц€жкую
ц€-л€т	ц€л€т
≥≥€пер	ц€пер
н€пер	ц€пер
н€пср	ц€пер
п€пер	ц€пер
цнпер	ц€пер
цн-пер	ц€пер
ц€лер	ц€пер
ц€нер	ц€пер
ц€пео	ц€пер
ц€-пер	ц€пер
ц€пср	ц€пер
ц€≥≥ер	ц€пер ц€цер
ц€пераш-н€е	ц€перашн€е
ча-вуск≥	чавуск≥
ча-го	чаго
чвго	чаго
чакас	чакае
чакаюнь	чакаюць
ча-каюць	чакаюць
чалааек	чалавек
ча-лавек	чалавек
чала-век	чалавек
„алавок	чалавек
чалавок	чалавек
чалавск	чалавек
чалапек	чалавек
чала€ек	чалавек
чалввек	чалавек
чвлавек	чалавек
чвлв-век	чалавек
чалааека	чалавека
ча-лавека	чалавека
чала-века	чалавека
чалаве-ка	чалавека
чалавекл	чалавека
чалавек€	чалавека
чалавска	чалавека
чала-вска	чалавека
чалавс-ка	чалавека
чаланека	чалавека
чала€ека	чалавека
чаллвека	чалавека
чвлввекв	чалавека
чллавека	чалавека
ча-лавекам	чалавекам
чалавс-кам	чалавекам
чала-векапамывак	чалавекапамывак
чалавекапамы-вак	чалавекапамывак
чалавску	чалавеку
чал€веку	чалавеку
чалавентва	чалавецтва
чалавент-ва	чалавецтва
чалавептва	чалавецтва
чалавецгва	чалавецтва
ча-лавецтва	чалавецтва
чала-вецтва	чалавецтва
чалавец-тва	чалавецтва
чалавецт-ва	чалавецтва
ча-лавецтвам	чалавецтвам
чала-вецтвам	чалавецтвам
ча-лавечага	чалавечага
чалаве-чага	чалавечага
чалавсчай	чалавечай
чалавеч-нага	чалавечнага
ча-му	чаму
члму	чаму
чамусы≥≥	чамусьц≥
чамусьн≥	чамусьц≥
ча-мусьц≥	чамусьц≥
ча-паць	чапаць
чар-гу	чаргу
чарна-баеҐ	чарнабаеҐ
чвс	час
члс	час
ч€с	час
ча-сам	часам
часлм	часам
час€м	часам
„всоп≥с	„асоп≥с
ча-соп≥са	часоп≥са
ча-соп≥сах	часоп≥сах
часо-п≥се	часоп≥се
часо-п≥сы	часоп≥сы
ча-ста	часта
члста	часта
ча-стка	частка
ча-стк≥	частк≥
част-к≥	частк≥
ча-стку	частку
ча-су	часу
члсу	часу
часней	часцей
час-цей	часцей
ча-тырох	чатырох
ча-тыры	чатыры
чатыры-ста	чатырыста
чацпвртай	чацвЄртай
чорна-га	чорнага
чор-най	чорнай
чор-тава	чортава
чу-жыне	чужыне
чу-жых	чужых
чу-л≥с€	чул≥с€
„ухааа	„ухава
чу-юцца	чуюцца
чы-гуначн≥каҐ	чыгуначн≥каҐ
чырво-на€	чырвона€
чыр-воны	чырвоны
чырво-ны	чырвоны
чырво-ным	чырвоным
чырво-ных	чырвоных
чы-ста€	чыста€
чы-сты	чысты
чы-сты€	чысты€
чыта-ла	чытала
чыта-л≥	чытал≥
чы-танн€	чытанн€
чытань	чытаць
чы-тань	чытаць
чытапь	чытаць
чы-тач	чытач
чыта-ча	чытача
чытлча	чытача
чы-тачам	чытачам
чыта-чам	чытачам
чы-тачоҐ	чытачоҐ
чыта-чоҐ	чытачоҐ
чытвчоҐ	чытачоҐ
чытлчоҐ	чытачоҐ
чы-т€чоҐ	чытачоҐ
чм-тачы	чытачы
чыта-чы	чытачы
чы-таюцца	чытаюцца
чэхасла-вак≥≥	чэхаславак≥≥
шаб-лон	шаблон
Ўлм€к≥н	Ўам€к≥н
шам€-к≥на	шам€к≥на
шарахоуск≥	шарахоҐск≥
шара-хоуск≥	шарахоҐск≥
ЎаҐчэпка	ЎаҐчэнка
шафср	шафер
шахцЄ-раҐ	шахцЄраҐ
ша-шы	шашы
шваг-ра	швагра
швей-най	швейнай
швей-ны€	швейны€
Ўвейцары≤	Ўвейцары≥
шка-да	шкада
школв	школа
школ€	школа
шко-лах	школах
шко-ле-	школе
школс	школе
школм	школы
шко-лы	школы
школь-нага	школьнага
школы≥≥каҐ	школьн≥каҐ
≤≤≤мат	шмат
шмвт	шмат
шматл≥-к≥м≥	шматл≥к≥м≥
шмат-л≥к≥х	шматл≥к≥х
шматл≥-к≥€	шматл≥к≥€
шм€т-л≥к≥€	шматл≥к≥€
шматтыраж-най	шматтыражнай
шпа-коҐск≥	шпакоҐск≥
шта-таҐ	штатаҐ
≥≥≥то	што
≤≤≤то	што
≥нто	што
≥пто	што
≤ѕто	што
н≥то	што
п≥то	што
шго	што
штп	што
штезЄнна	штодзЄнна
што-дзЄнна	штодзЄнна
штодзЄннл	штодзЄнна
штодэЄнна	штодзЄнна
штонсбудзь	што-небудзь
штосы≥≥	штосьц≥
штосьн≥	штосьц≥
штуч-ны	штучны
штуч-ных	штучных
шу-каць	шукаць
шу-му	шуму
шчасл≥-вае	шчасл≥вае
шчасл≥-вай	шчасл≥вай
шча-сл≥вую	шчасл≥вую
шчасне	шчасце
шчас-цем	шчасцем
шчасн€	шчасц€
шчасп€	шчасц€
шча-сц€	шчасц€
шчолра	шчодра
шчы-ра	шчыра
шчы-рага	шчырага
шчырасн≥	шчырасц≥
шыр-мы	шырмы
шы-рока	шырока
шырокв	шырока
шы-рокага	шырокага
шыро-кага	шырокага
шырока-га	шырокага
шы-рокае	шырокае
шы-рокай	шырокай
шыро-ка€	шырока€
шыро-к≥м	шырок≥м
шы-рокую	шырокую
шыро-кую	шырокую
шыры-ню	шырыню
эйхма-на	эйхмана
эка-нам≥чнага	эканам≥чнага
эканам≥ч-нага	эканам≥чнага
экана-м≥чнае	эканам≥чнае
эка-нам≥чным	эканам≥чным
экана-м≥чным	эканам≥чным
эканам≥ч-ным	эканам≥чным
экана-м≥чных	эканам≥чных
экано-м≥к≥	эканом≥к≥
эканом≥-к≥	эканом≥к≥
экэ	экз
экэамены	экзамены
экс-панаты	экспанаты
экс-пануюцца	экспануюцца
эксперы-менталы≥ага	эксперыментальнага
электрыф≥ка-цы≥	электрыф≥кацы≥
элемен-ты	элементы
эн-гельса	энгельса
энер-г≥≥	энерг≥≥
эп≥зол	эп≥зод
эп≥золах	эп≥зодах
эпо-х≥	эпох≥
эпо-ху	эпоху
эст-радзе	эстрадзе
эстэ-тычнага	эстэтычнага
эстэ-тычны	эстэтычны
эу-с≥м	эус≥м
юна-га	юнага
юна-к≥	юнак≥
юна-коҐ	юнакоҐ
юнац-тва	юнацтва
ю≥≥ых	юных
ёрын	ёрый
нго	€го
чго	€го
€гп	€го
€дзер-най	€дзернай
яƒЌјѕ÷≈—я	€днайцес€
€касн≥	€касц≥
€ка-сц≥	€касц≥
€клсц≥	€касц≥
€кас-ц€х	€касц€х
яклҐ	якаҐ
€кан	€ка€
€-ка€	€ка€
€кл€	€ка€
€кэ€	€ка€
€к€€	€ка€
€х≥	€к≥
€к≥-м≥	€к≥м≥
€к≥хнебудзь	€к≥х-небудзь
пк≥€	€к≥€
€к≥ч	€к≥€
€н≥€	€к≥€
нкога	€кога
€когв	€кога
€ког€	€кога
€кос	€кое
€ко≥≥	€кой
€кон	€кой
€койнебудзь	€кой-небудзь
€к-раз	€краз
€краэ	€краз
якубв	якуба
€куюнебудзь	€кую-небудзь
ямв	яма
нму	€му
€нв	€на
янз	яна
€н€	€на
€па	€на
€≥≥ы	€ны
я≥≥ы	яны
€нм	€ны
янм	€ны
€-ны	€ны
€нь≥	€ны
€пы	€ны
€р-к≥м	€рк≥м
€сн€	€сна
ншчэ	€шчэ
чшчэ	€шчэ
€≥≥≥чэ	€шчэ
€≥нчэ	€шчэ
€≥пчэ	€шчэ
€шч	€шчэ
€шч>	€шчэ
€шчз	€шчэ
€ш-чэ	€шчэ